年月日,観客数,勝敗,対戦相手,先発投手,試合時間,球場,年,月,日,曜日,降水量の合計(mm),平均気温(℃),スコア(ホーム),スコア(相手),スコア(合計),スコア(差),直前試合のスコア(ホーム),直前試合のスコア(相手),直前試合のスコア(合計),直前試合のスコア(差),直前試合の勝敗,月別平均観客数,日別平均観客数
2009/4/7,24011,○,オリックス,岸,196,西武ドーム,2009,4,7,火,0.0,14.2,8,3,11,5,3,2,7,1,△,17693.64,18786.29
2009/4/8,10001,●,オリックス,石井一,185,西武ドーム,2009,4,8,水,0.0,14.1,2,10,12,-8,8,3,11,5,○,17693.64,17143.54
2009/4/9,9813,○,オリックス,西口,177,西武ドーム,2009,4,9,木,0.0,16.5,13,6,19,7,2,10,12,-8,●,17693.64,18510.93
2009/4/17,15181,●,日本ハム,涌井,200,西武ドーム,2009,4,17,金,5.0,10.8,2,4,6,-2,13,6,19,7,○,17693.64,20806.97
2009/4/18,28525,●,日本ハム,帆足,204,西武ドーム,2009,4,18,土,0.0,13.6,4,6,10,-2,2,4,6,-2,●,17693.64,19713.64
2009/4/19,22315,●,日本ハム,その他,242,西武ドーム,2009,4,19,日,0.0,15.9,6,8,14,-2,4,6,10,-2,●,17693.64,19628.91
2009/4/24,12618,○,ロッテ,涌井,146,西武ドーム,2009,4,24,金,1.5,11.6,3,1,4,2,6,8,14,-2,●,17693.64,18457.52
2009/4/25,23147,●,ロッテ,帆足,185,西武ドーム,2009,4,25,土,52.0,9.8,2,3,5,-1,3,1,4,2,○,17693.64,19019.58
2009/4/26,23647,●,ロッテ,その他,215,西武ドーム,2009,4,26,日,0.0,15.6,5,11,16,-6,2,3,5,-1,●,17693.64,19753.74
2009/4/28,16151,○,ソフトバンク,岸,190,西武ドーム,2009,4,28,火,0.0,12.1,5,4,9,1,5,11,16,-6,●,17693.64,20998.5
2009/4/29,28855,○,ソフトバンク,石井一,176,西武ドーム,2009,4,29,水,0.0,13.4,7,2,9,5,5,4,9,1,○,17693.64,22562.68
2009/4/30,15720,●,ソフトバンク,西口,213,西武ドーム,2009,4,30,木,0.0,15.8,5,8,13,-3,7,2,9,5,○,17693.64,21898.1
2009/5/4,33911,○,楽天,岸,173,西武ドーム,2009,5,4,月,0.0,18.1,8,3,11,5,5,8,13,-3,●,22741.88,22697.37
2009/5/5,33908,●,楽天,石井一,201,西武ドーム,2009,5,5,火,11.5,15.8,3,7,10,-4,8,3,11,5,○,22741.88,23356.53
2009/5/6,31440,●,楽天,西口,210,西武ドーム,2009,5,6,水,27.5,14.5,3,6,9,-3,3,7,10,-4,●,22741.88,19710.77
2009/5/19,18110,●,中日,岸,210,大宮,2009,5,19,火,0.0,19.5,5,7,12,-2,3,6,9,-3,●,22741.88,19628.91
2009/5/20,19203,○,中日,石井一,206,西武ドーム,2009,5,20,水,0.0,21.8,2,1,3,1,5,7,12,-2,●,22741.88,20765.17
2009/5/22,16323,●,DeNA,涌井,193,西武ドーム,2009,5,22,金,0.0,21.3,5,15,20,-10,2,1,3,1,○,22741.88,19673.16
2009/5/23,24471,○,DeNA,帆足,187,西武ドーム,2009,5,23,土,10.0,21.7,10,6,16,4,5,15,20,-10,●,22741.88,21263.5
2009/5/30,33778,△,巨人,帆足,238,西武ドーム,2009,5,30,土,6.5,17.9,2,2,4,0,10,6,16,4,○,22741.88,21898.1
2009/5/31,33173,○,巨人,岸,235,西武ドーム,2009,5,31,日,1.5,18.8,3,2,5,1,2,2,4,0,△,22741.88,21679.45
2009/6/2,16001,○,ヤクルト,その他,179,西武ドーム,2009,6,2,火,0.0,19.0,7,3,10,4,3,2,5,1,○,22359.4,20570.03
2009/6/3,16181,○,ヤクルト,涌井,158,西武ドーム,2009,6,3,水,0.0,19.6,8,1,9,7,7,3,10,4,○,22359.4,21970.81
2009/6/10,29006,○,阪神,涌井,160,西武ドーム,2009,6,10,水,0.0,21.7,4,3,7,1,8,1,9,7,○,22359.4,17777.52
2009/6/11,28371,○,阪神,その他,184,西武ドーム,2009,6,11,木,8.0,19.7,6,5,11,1,4,3,7,1,○,22359.4,21121.18
2009/6/13,33747,○,広島,帆足,171,西武ドーム,2009,6,13,土,0.0,22.2,4,2,6,2,6,5,11,1,○,22359.4,19970.56
2009/6/14,32795,△,広島,岸,279,西武ドーム,2009,6,14,日,1.0,20.7,4,4,8,0,4,2,6,2,○,22359.4,20046.41
2009/6/26,17215,○,ソフトバンク,涌井,172,大宮,2009,6,26,金,0.0,25.1,10,4,14,6,4,4,8,0,△,22359.4,19753.74
2009/6/27,30200,●,ソフトバンク,石井一,204,西武ドーム,2009,6,27,土,0.0,25.3,3,10,13,-7,10,4,14,6,○,22359.4,21138.49
2009/6/28,28238,●,ソフトバンク,その他,207,西武ドーム,2009,6,28,日,13.5,22.0,5,7,12,-2,3,10,13,-7,●,22359.4,20998.5
2009/6/30,11391,●,ロッテ,帆足,260,西武ドーム,2009,6,30,火,3.0,21.9,6,8,14,-2,5,7,12,-2,●,22359.4,21898.1
2009/7/1,11617,○,ロッテ,岸,204,西武ドーム,2009,7,1,水,2.5,21.5,11,6,17,5,6,8,14,-2,●,19106.44,22001.45
2009/7/2,11156,●,ロッテ,西口,342,西武ドーム,2009,7,2,木,3.0,20.3,8,9,17,-1,11,6,17,5,○,19106.44,20570.03
2009/7/7,12525,○,日本ハム,岸,162,西武ドーム,2009,7,7,火,0.0,25.7,6,4,10,2,8,9,17,-1,●,19106.44,18786.29
2009/7/8,13892,○,日本ハム,西口,184,西武ドーム,2009,7,8,水,0.5,25.1,4,3,7,1,6,4,10,2,○,19106.44,17143.54
2009/7/9,12625,○,日本ハム,涌井,206,西武ドーム,2009,7,9,木,1.0,25.9,8,2,10,6,4,3,7,1,○,19106.44,18510.93
2009/7/10,11178,●,オリックス,石井一,199,西武ドーム,2009,7,10,金,0.0,27.0,3,6,9,-3,8,2,10,6,○,19106.44,17777.52
2009/7/11,22516,○,オリックス,その他,270,西武ドーム,2009,7,11,土,0.0,23.3,5,4,9,1,3,6,9,-3,●,19106.44,21121.18
2009/7/12,21334,○,オリックス,帆足,174,西武ドーム,2009,7,12,日,0.0,23.5,3,2,5,1,5,4,9,1,○,19106.44,20345.97
2009/7/14,14790,●,楽天,岸,226,西武ドーム,2009,7,14,火,0.0,26.5,6,8,14,-2,3,2,5,1,○,19106.44,20046.41
2009/7/15,13989,○,楽天,涌井,170,西武ドーム,2009,7,15,水,0.0,28.7,5,0,5,5,6,8,14,-2,●,19106.44,21160.21
2009/7/16,14471,●,楽天,西口,179,西武ドーム,2009,7,16,木,0.0,28.4,1,3,4,-2,5,0,5,5,○,19106.44,20196.04
2009/7/20,20521,○,オリックス,岸,163,西武ドーム,2009,7,20,月,0.0,25.5,4,1,5,3,1,3,4,-2,●,19106.44,20765.17
2009/7/21,13759,○,オリックス,涌井,208,西武ドーム,2009,7,21,火,3.0,21.5,4,2,6,2,4,1,5,3,○,19106.44,20805.45
2009/7/22,13445,●,オリックス,帆足,226,西武ドーム,2009,7,22,水,4.0,22.7,2,4,6,-2,4,2,6,2,○,19106.44,19673.16
2009/8/4,20473,●,日本ハム,涌井,214,大宮,2009,8,4,火,0.0,25.4,1,5,6,-4,2,4,6,-2,●,20720.23,22697.37
2009/8/5,18510,○,日本ハム,石井一,181,西武ドーム,2009,8,5,水,0.0,26.5,5,2,7,3,1,5,6,-4,●,20720.23,23356.53
2009/8/6,19360,●,日本ハム,その他,202,西武ドーム,2009,8,6,木,0.0,26.5,4,7,11,-3,5,2,7,3,○,20720.23,19710.77
2009/8/7,17476,●,ソフトバンク,帆足,189,西武ドーム,2009,8,7,金,48.5,26.3,4,5,9,-1,4,7,11,-3,●,20720.23,18786.29
2009/8/8,28911,○,ソフトバンク,岸,197,西武ドーム,2009,8,8,土,0.0,25.3,12,3,15,9,4,5,9,-1,●,20720.23,17143.54
2009/8/9,29660,●,ソフトバンク,野上,196,西武ドーム,2009,8,9,日,1.5,26.0,1,4,5,-3,12,3,15,9,○,20720.23,18510.93
2009/8/21,18061,●,ロッテ,帆足,247,西武ドーム,2009,8,21,金,0.0,26.0,7,12,19,-5,1,4,5,-3,●,20720.23,20805.45
2009/8/22,31333,○,ロッテ,岸,185,西武ドーム,2009,8,22,土,6.5,26.8,1,0,1,1,7,12,19,-5,●,20720.23,19673.16
2009/8/23,25201,○,ロッテ,野上,146,西武ドーム,2009,8,23,日,0.0,24.8,1,0,1,1,1,0,1,1,○,20720.23,21263.5
2009/8/25,23125,○,楽天,涌井,245,西武ドーム,2009,8,25,火,0.0,23.3,3,2,5,1,1,0,1,1,○,20720.23,19019.58
2009/8/26,18031,●,楽天,石井一,174,西武ドーム,2009,8,26,水,0.0,22.9,0,6,6,-6,3,2,5,1,○,20720.23,19753.74
2009/8/27,21777,●,楽天,その他,205,西武ドーム,2009,8,27,木,0.0,23.9,0,4,4,-4,0,6,6,-6,●,20720.23,21138.49
2009/9/8,15346,○,日本ハム,涌井,185,西武ドーム,2009,9,8,火,0.0,24.2,5,0,5,5,0,4,4,-4,●,20473.55,17143.54
2009/9/9,14018,○,日本ハム,石井一,177,西武ドーム,2009,9,9,水,0.0,21.3,7,4,11,3,5,0,5,5,○,20473.55,18510.93
2009/9/10,15160,○,日本ハム,西口,198,西武ドーム,2009,9,10,木,0.0,21.1,5,4,9,1,7,4,11,3,○,20473.55,17777.52
2009/9/11,11653,○,オリックス,帆足,158,西武ドーム,2009,9,11,金,0.0,21.5,2,1,3,1,5,4,9,1,○,20473.55,21121.18
2009/9/12,21547,●,オリックス,岸,173,西武ドーム,2009,9,12,土,1.5,19.6,2,3,5,-1,2,1,3,1,○,20473.55,20345.97
2009/9/13,20460,○,オリックス,野上,225,西武ドーム,2009,9,13,日,0.0,22.1,10,8,18,2,2,3,5,-1,●,20473.55,19970.56
2009/9/18,15487,○,ソフトバンク,帆足,149,西武ドーム,2009,9,18,金,0.0,19.5,6,0,6,6,10,8,18,2,○,20473.55,19713.64
2009/9/19,27751,●,ソフトバンク,岸,171,西武ドーム,2009,9,19,土,0.0,20.7,1,6,7,-5,6,0,6,6,○,20473.55,19628.91
2009/9/20,33516,○,ソフトバンク,石井一,187,西武ドーム,2009,9,20,日,0.0,22.0,8,1,9,7,1,6,7,-5,●,20473.55,20765.17
2009/9/25,23261,○,楽天,帆足,168,西武ドーム,2009,9,25,金,0.0,21.5,7,1,8,6,8,1,9,7,○,20473.55,19019.58
2009/9/26,33731,●,楽天,岸,239,西武ドーム,2009,9,26,土,0.0,21.7,6,10,16,-4,7,1,8,6,○,20473.55,19753.74
2009/9/27,33901,●,楽天,涌井,225,西武ドーム,2009,9,27,日,0.0,21.1,4,11,15,-7,6,10,16,-4,●,20473.55,21138.49
2009/9/29,14063,●,ロッテ,石井一,195,西武ドーム,2009,9,29,火,1.0,20.6,3,13,16,-10,4,11,15,-7,●,20473.55,22562.68
2009/9/30,12762,●,ロッテ,その他,208,西武ドーム,2009,9,30,水,10.5,18.5,2,9,11,-7,3,13,16,-10,●,20473.55,21898.1
2009/10/1,25207,○,ロッテ,西口,164,西武ドーム,2009,10,1,木,0.5,19.4,2,1,3,1,2,9,11,-7,●,16821.42,22001.45
2010/3/20,33331,○,ロッテ,涌井,158,西武ドーム,2010,3,20,土,0.0,13.6,2,1,3,1,2,1,3,1,○,23307.61,20765.17
2010/3/21,27682,●,ロッテ,帆足,178,西武ドーム,2010,3,21,日,0.0,13.7,1,2,3,-1,2,1,3,1,○,23307.61,20805.45
2010/3/22,28448,●,ロッテ,岸,198,西武ドーム,2010,3,22,月,0.0,8.2,2,13,15,-11,1,2,3,-1,●,23307.61,19673.16
2010/3/30,15140,○,ソフトバンク,岸,200,西武ドーム,2010,3,30,火,0.0,4.4,3,2,5,1,2,13,15,-11,●,23307.61,21898.1
2010/3/31,13782,○,ソフトバンク,石井一,179,西武ドーム,2010,3,31,水,0.0,5.7,9,3,12,6,3,2,5,1,○,23307.61,21679.45
2010/4/1,14797,●,ソフトバンク,西口,198,西武ドーム,2010,4,1,木,0.0,12.4,5,11,16,-6,9,3,12,6,○,17693.64,22001.45
2010/4/6,13248,○,オリックス,岸,177,西武ドーム,2010,4,6,火,0.5,12.6,3,0,3,3,5,11,16,-6,●,17693.64,19710.77
2010/4/7,9880,○,オリックス,石井一,183,西武ドーム,2010,4,7,水,5.0,9.7,9,2,11,7,3,0,3,3,○,17693.64,18786.29
2010/4/8,9256,●,オリックス,西口,220,西武ドーム,2010,4,8,木,0.0,8.1,4,5,9,-1,9,2,11,7,○,17693.64,17143.54
2010/4/13,13442,○,楽天,岸,188,西武ドーム,2010,4,13,火,3.5,14.7,5,3,8,2,4,5,9,-1,●,17693.64,19970.56
2010/4/14,11980,○,楽天,石井一,211,西武ドーム,2010,4,14,水,0.0,11.5,6,5,11,1,5,3,8,2,○,17693.64,20046.41
2010/4/15,10059,○,楽天,西口,176,西武ドーム,2010,4,15,木,5.5,5.8,7,3,10,4,6,5,11,1,○,17693.64,21160.21
2010/4/16,13054,○,日本ハム,涌井,176,西武ドーム,2010,4,16,金,11.0,3.9,7,3,10,4,7,3,10,4,○,17693.64,20196.04
2010/4/17,26793,●,日本ハム,その他,198,西武ドーム,2010,4,17,土,23.5,5.6,5,8,13,-3,7,3,10,4,○,17693.64,20806.97
2010/4/18,24432,○,日本ハム,帆足,148,西武ドーム,2010,4,18,日,0.0,9.9,3,0,3,3,5,8,13,-3,●,17693.64,19713.64
2010/4/27,13835,○,ロッテ,岸,178,西武ドーム,2010,4,27,火,14.5,10.4,3,1,4,2,3,0,3,3,○,17693.64,21138.49
2010/4/28,15482,○,ロッテ,石井一,162,西武ドーム,2010,4,28,水,41.0,12.3,3,1,4,2,3,1,4,2,○,17693.64,20998.5
2010/4/29,30881,●,ロッテ,その他,204,西武ドーム,2010,4,29,木,0.0,16.6,5,10,15,-5,3,1,4,2,○,17693.64,22562.68
2010/5/3,33603,●,楽天,西口,192,西武ドーム,2010,5,3,月,0.0,16.8,4,5,9,-1,5,10,15,-5,●,22741.88,21970.81
2010/5/4,32419,○,楽天,岸,276,西武ドーム,2010,5,4,火,0.0,18.8,6,5,11,1,4,5,9,-1,●,22741.88,22697.37
2010/5/5,30405,○,楽天,石井一,218,西武ドーム,2010,5,5,水,0.0,20.6,19,3,22,16,6,5,11,1,○,22741.88,23356.53
2010/5/18,20011,○,ヤクルト,岸,171,大宮,2010,5,18,火,0.0,20.4,1,0,1,1,19,3,22,16,○,22741.88,19713.64
2010/5/19,16125,○,ヤクルト,石井一,185,西武ドーム,2010,5,19,水,13.5,18.6,3,2,5,1,1,0,1,1,○,22741.88,19628.91
2010/5/21,18546,●,中日,涌井,193,西武ドーム,2010,5,21,金,0.0,22.4,1,3,4,-2,3,2,5,1,○,22741.88,20805.45
2010/5/22,32211,○,中日,帆足,167,西武ドーム,2010,5,22,土,0.0,21.5,8,0,8,8,1,3,4,-2,●,22741.88,19673.16
2010/5/29,33911,●,巨人,帆足,165,西武ドーム,2010,5,29,土,1.5,13.8,0,4,4,-4,8,0,8,8,○,22741.88,22562.68
2010/5/30,33916,●,巨人,岸,187,西武ドーム,2010,5,30,日,0.5,13.1,1,5,6,-4,0,4,4,-4,●,22741.88,21898.1
2010/6/1,15313,●,DeNA,石井一,184,西武ドーム,2010,6,1,火,0.0,17.6,2,6,8,-4,1,5,6,-4,●,22359.4,22001.45
2010/6/2,15949,○,DeNA,涌井,193,西武ドーム,2010,6,2,水,0.0,18.5,3,2,5,1,2,6,8,-4,●,22359.4,20570.03
2010/6/9,30844,○,阪神,涌井,181,西武ドーム,2010,6,9,水,2.5,19.2,2,1,3,1,3,2,5,1,○,22359.4,18510.93
2010/6/10,28892,●,阪神,石井一,205,西武ドーム,2010,6,10,木,1.0,21.4,4,8,12,-4,2,1,3,1,○,22359.4,17777.52
2010/6/12,31618,●,広島,帆足,200,西武ドーム,2010,6,12,土,0.0,23.7,2,6,8,-4,4,8,12,-4,●,22359.4,20345.97
2010/6/13,31647,●,広島,岸,195,西武ドーム,2010,6,13,日,0.0,21.8,2,4,6,-2,2,6,8,-4,●,22359.4,19970.56
2010/6/18,15655,○,ソフトバンク,涌井,177,西武ドーム,2010,6,18,金,18.0,23.1,8,1,9,7,2,4,6,-2,●,22359.4,19713.64
2010/6/19,26845,○,ソフトバンク,帆足,173,西武ドーム,2010,6,19,土,8.0,23.6,5,1,6,4,8,1,9,7,○,22359.4,19628.91
2010/6/20,24276,○,ソフトバンク,その他,210,西武ドーム,2010,6,20,日,0.0,25.3,6,4,10,2,5,1,6,4,○,22359.4,20765.17
2010/6/25,13279,○,オリックス,涌井,196,西武ドーム,2010,6,25,金,0.0,24.2,7,3,10,4,6,4,10,2,○,22359.4,19019.58
2010/6/26,24896,●,オリックス,帆足,219,西武ドーム,2010,6,26,土,3.0,24.1,5,7,12,-2,7,3,10,4,○,22359.4,19753.74
2010/6/27,22010,○,オリックス,その他,200,西武ドーム,2010,6,27,日,5.0,25.0,4,2,6,2,5,7,12,-2,●,22359.4,21138.49
2010/6/29,24323,●,日本ハム,岸,198,新潟,2010,6,29,火,82.5,25.0,4,6,10,-2,4,2,6,2,○,22359.4,22562.68
2010/6/30,20314,●,日本ハム,野上,270,大宮,2010,6,30,水,32.0,24.5,4,7,11,-3,4,6,10,-2,●,22359.4,21898.1
2010/7/1,13605,●,日本ハム,西口,236,西武ドーム,2010,7,1,木,7.5,25.0,7,9,16,-2,4,7,11,-3,●,19106.44,22001.45
2010/7/10,29104,●,楽天,涌井,205,西武ドーム,2010,7,10,土,0.0,26.0,1,7,8,-6,7,9,16,-2,●,19106.44,17777.52
2010/7/11,26840,○,楽天,帆足,222,西武ドーム,2010,7,11,日,0.0,24.9,8,4,12,4,1,7,8,-6,●,19106.44,21121.18
2010/7/13,14811,●,日本ハム,その他,190,西武ドーム,2010,7,13,火,1.5,21.5,1,9,10,-8,8,4,12,4,○,19106.44,19970.56
2010/7/14,15448,○,日本ハム,野上,197,西武ドーム,2010,7,14,水,5.5,22.7,3,2,5,1,1,9,10,-8,●,19106.44,20046.41
2010/7/15,15824,○,日本ハム,その他,170,西武ドーム,2010,7,15,木,0.0,25.3,7,0,7,7,3,2,5,1,○,19106.44,21160.21
2010/7/27,21554,●,ロッテ,その他,174,西武ドーム,2010,7,27,火,0.0,28.4,3,5,8,-2,7,0,7,7,○,19106.44,21138.49
2010/7/28,21582,●,ロッテ,その他,191,西武ドーム,2010,7,28,水,0.0,28.8,4,9,13,-5,3,5,8,-2,●,19106.44,20998.5
2010/7/29,21571,○,ロッテ,その他,210,西武ドーム,2010,7,29,木,5.5,24.9,12,6,18,6,4,9,13,-5,●,19106.44,22562.68
2010/8/6,18844,○,ソフトバンク,涌井,196,西武ドーム,2010,8,6,金,0.0,28.3,10,4,14,6,12,6,18,6,○,20720.23,19710.77
2010/8/7,26661,○,ソフトバンク,帆足,190,西武ドーム,2010,8,7,土,0.0,27.7,5,4,9,1,10,4,14,6,○,20720.23,18786.29
2010/8/8,24413,○,ソフトバンク,その他,216,西武ドーム,2010,8,8,日,4.0,27.1,7,4,11,3,5,4,9,1,○,20720.23,17143.54
2010/8/13,25389,○,オリックス,涌井,221,西武ドーム,2010,8,13,金,7.5,26.0,4,2,6,2,7,4,11,3,○,20720.23,19970.56
2010/8/14,25989,○,オリックス,帆足,244,西武ドーム,2010,8,14,土,0.0,26.3,8,3,11,5,4,2,6,2,○,20720.23,20046.41
2010/8/15,22643,○,オリックス,西口,195,西武ドーム,2010,8,15,日,0.0,28.8,6,1,7,5,8,3,11,5,○,20720.23,21160.21
2010/8/17,20808,●,ソフトバンク,その他,226,西武ドーム,2010,8,17,火,0.0,30.5,4,5,9,-1,6,1,7,5,○,20720.23,20806.97
2010/8/18,19414,○,ソフトバンク,石井一,206,西武ドーム,2010,8,18,水,69.0,28.6,4,3,7,1,4,5,9,-1,●,20720.23,19713.64
2010/8/19,21219,○,ソフトバンク,野上,202,西武ドーム,2010,8,19,木,2.0,27.3,5,1,6,4,4,3,7,1,○,20720.23,19628.91
2010/8/27,21504,●,楽天,その他,213,西武ドーム,2010,8,27,金,0.0,28.6,3,11,14,-8,5,1,6,4,○,20720.23,21138.49
2010/8/28,28856,△,楽天,涌井,323,西武ドーム,2010,8,28,土,0.0,28.4,5,5,10,0,3,11,14,-8,●,20720.23,20998.5
2010/8/29,27093,○,楽天,帆足,187,西武ドーム,2010,8,29,日,0.0,28.3,5,3,8,2,5,5,10,0,△,20720.23,22562.68
2010/8/31,16823,●,オリックス,その他,233,前橋,2010,8,31,火,0.0,28.9,4,8,12,-4,5,3,8,2,○,20720.23,21679.45
2010/9/1,18597,○,オリックス,石井一,202,大宮,2010,9,1,水,0.0,28.9,7,4,11,3,4,8,12,-4,●,20473.55,22001.45
2010/9/2,14028,○,オリックス,西口,214,西武ドーム,2010,9,2,木,0.0,28.4,3,0,3,3,7,4,11,3,○,20473.55,20570.03
2010/9/7,15420,○,日本ハム,その他,186,西武ドーム,2010,9,7,火,0.0,29.9,6,5,11,1,3,0,3,3,○,20473.55,18786.29
2010/9/8,15449,○,日本ハム,石井一,177,西武ドーム,2010,9,8,水,31.0,23.8,8,3,11,5,6,5,11,1,○,20473.55,17143.54
2010/9/9,19858,●,日本ハム,その他,175,西武ドーム,2010,9,9,木,0.0,24.2,0,5,5,-5,8,3,11,5,○,20473.55,18510.93
2010/9/10,23668,○,ロッテ,西口,208,西武ドーム,2010,9,10,金,0.0,24.8,12,8,20,4,0,5,5,-5,●,20473.55,17777.52
2010/9/11,33920,○,ロッテ,涌井,199,西武ドーム,2010,9,11,土,0.0,27.0,4,2,6,2,12,8,20,4,○,20473.55,21121.18
2010/9/12,33921,○,ロッテ,帆足,188,西武ドーム,2010,9,12,日,0.0,27.5,14,3,17,11,4,2,6,2,○,20473.55,20345.97
2010/9/23,33917,●,楽天,涌井,222,西武ドーム,2010,9,23,木,49.0,17.8,3,4,7,-1,14,3,17,11,○,20473.55,21263.5
2011/4/26,14991,●,楽天,涌井,177,皇子山,2011,4,26,火,0.0,12.8,0,2,2,-2,3,4,7,-1,●,17693.64,19753.74
2011/5/3,33907,●,ロッテ,涌井,217,西武ドーム,2011,5,3,火,7.5,14.3,5,10,15,-5,0,2,2,-2,●,22741.88,21970.81
2011/5/4,31282,●,ロッテ,石井一,171,西武ドーム,2011,5,4,水,0.0,15.7,2,8,10,-6,5,10,15,-5,●,22741.88,22697.37
2011/5/5,32954,○,ロッテ,西口,169,西武ドーム,2011,5,5,木,0.0,13.5,5,3,8,2,2,8,10,-6,●,22741.88,23356.53
2011/5/17,17367,○,DeNA,涌井,158,大宮,2011,5,17,火,0.0,15.9,4,1,5,3,5,3,8,2,○,22741.88,20806.97
2011/5/18,15451,○,DeNA,石井一,169,西武ドーム,2011,5,18,水,0.0,17.8,5,2,7,3,4,1,5,3,○,22741.88,19713.64
2011/5/20,16814,●,中日,牧田,202,西武ドーム,2011,5,20,金,0.0,20.9,5,6,11,-1,5,2,7,3,○,22741.88,20765.17
2011/5/21,28205,○,中日,岸,211,西武ドーム,2011,5,21,土,0.0,21.7,13,4,17,9,5,6,11,-1,●,22741.88,20805.45
2011/5/28,27976,○,ヤクルト,岸,162,西武ドーム,2011,5,28,土,18.5,17.1,3,2,5,1,13,4,17,9,○,22741.88,20998.5
2011/5/29,26115,○,ヤクルト,帆足,192,西武ドーム,2011,5,29,日,86.0,17.4,10,1,11,9,3,2,5,1,○,22741.88,22562.68
2011/5/31,25354,●,巨人,石井一,161,西武ドーム,2011,5,31,火,0.0,15.0,1,4,5,-3,10,1,11,9,○,22741.88,21679.45
2011/6/1,27066,○,巨人,涌井,147,西武ドーム,2011,6,1,水,0.0,13.7,4,1,5,3,1,4,5,-3,●,22359.4,22001.45
2011/6/9,17268,●,広島,涌井,187,西武ドーム,2011,6,9,木,4.0,20.2,1,5,6,-4,4,1,5,3,○,22359.4,18510.93
2011/6/10,19687,△,広島,牧田,220,西武ドーム,2011,6,10,金,0.5,21.2,1,1,2,0,1,5,6,-4,●,22359.4,17777.52
2011/6/11,33918,●,阪神,石井一,159,西武ドーム,2011,6,11,土,19.0,21.3,0,4,4,-4,1,1,2,0,△,22359.4,21121.18
2011/6/12,33919,○,阪神,菊池,214,西武ドーム,2011,6,12,日,0.0,21.8,11,5,16,6,0,4,4,-4,●,22359.4,20345.97
2011/6/24,20338,○,楽天,帆足,204,大宮,2011,6,24,金,0.0,29.5,7,4,11,3,11,5,16,6,○,22359.4,18457.52
2011/6/25,31295,●,楽天,涌井,180,西武ドーム,2011,6,25,土,13.0,23.4,1,9,10,-8,7,4,11,3,○,22359.4,19019.58
2011/6/26,25033,○,楽天,石井一,181,西武ドーム,2011,6,26,日,0.0,20.2,5,4,9,1,1,9,10,-8,●,22359.4,19753.74
2011/6/27,16719,●,楽天,その他,192,西武ドーム,2011,6,27,月,0.5,21.1,1,2,3,-1,5,4,9,1,○,22359.4,21138.49
2011/7/1,15819,●,日本ハム,帆足,205,西武ドーム,2011,7,1,金,0.0,26.0,2,6,8,-4,1,2,3,-1,●,19106.44,22001.45
2011/7/2,27507,●,日本ハム,涌井,170,西武ドーム,2011,7,2,土,0.0,25.8,2,4,6,-2,2,6,8,-4,●,19106.44,20570.03
2011/7/3,26881,●,日本ハム,石井一,163,西武ドーム,2011,7,3,日,0.0,26.5,2,5,7,-3,2,4,6,-2,●,19106.44,21970.81
2011/7/5,14824,●,ソフトバンク,岸,227,西武ドーム,2011,7,5,火,2.0,26.9,2,7,9,-5,2,5,7,-3,●,19106.44,23356.53
2011/7/6,14833,●,ソフトバンク,西口,205,西武ドーム,2011,7,6,水,0.0,26.8,2,5,7,-3,2,7,9,-5,●,19106.44,19710.77
2011/7/8,11771,●,オリックス,帆足,229,西武ドーム,2011,7,8,金,1.0,27.2,3,7,10,-4,2,5,7,-3,●,19106.44,17143.54
2011/7/9,20996,○,オリックス,涌井,211,西武ドーム,2011,7,9,土,0.0,28.7,7,4,11,3,3,7,10,-4,●,19106.44,18510.93
2011/7/10,20273,○,オリックス,石井一,201,西武ドーム,2011,7,10,日,0.0,28.6,9,3,12,6,7,4,11,3,○,19106.44,17777.52
2011/7/11,17370,○,オリックス,岸,187,西武ドーム,2011,7,11,月,0.0,27.9,9,1,10,8,9,3,12,6,○,19106.44,21121.18
2011/7/25,24994,○,ロッテ,石井一,165,西武ドーム,2011,7,25,月,0.0,26.2,4,2,6,2,9,1,10,8,○,19106.44,19019.58
2011/7/26,18970,○,ロッテ,涌井,202,西武ドーム,2011,7,26,火,0.0,25.6,6,5,11,1,4,2,6,2,○,19106.44,19753.74
2011/7/27,18501,○,ロッテ,帆足,144,西武ドーム,2011,7,27,水,0.0,26.4,4,1,5,3,6,5,11,1,○,19106.44,21138.49
2011/7/28,17255,●,ロッテ,その他,160,西武ドーム,2011,7,28,木,8.0,25.1,0,1,1,-1,4,1,5,3,○,19106.44,20998.5
2011/7/29,16345,●,オリックス,岸,201,西武ドーム,2011,7,29,金,1.0,25.3,1,6,7,-5,0,1,1,-1,●,19106.44,22562.68
2011/7/30,24608,○,オリックス,西口,199,西武ドーム,2011,7,30,土,49.0,24.1,7,2,9,5,1,6,7,-5,●,19106.44,21898.1
2011/7/31,24359,○,オリックス,石井一,229,西武ドーム,2011,7,31,日,6.5,21.5,7,5,12,2,7,2,9,5,○,19106.44,21679.45
2011/8/5,17631,△,ソフトバンク,岸,227,西武ドーム,2011,8,5,金,12.0,26.4,4,4,8,0,7,5,12,2,○,20720.23,23356.53
2011/8/6,24416,△,ソフトバンク,西口,215,西武ドーム,2011,8,6,土,0.0,27.6,1,1,2,0,4,4,8,0,△,20720.23,19710.77
2011/8/7,22774,●,ソフトバンク,石井一,180,西武ドーム,2011,8,7,日,6.0,27.0,1,8,9,-7,1,1,2,0,△,20720.23,18786.29
2011/8/9,17638,●,日本ハム,涌井,200,西武ドーム,2011,8,9,火,0.0,28.8,0,4,4,-4,1,8,9,-7,●,20720.23,18510.93
2011/8/10,17362,○,日本ハム,帆足,259,西武ドーム,2011,8,10,水,0.0,29.6,9,8,17,1,0,4,4,-4,●,20720.23,17777.52
2011/8/11,21941,○,日本ハム,菊池,198,西武ドーム,2011,8,11,木,0.0,29.1,9,4,13,5,9,8,17,1,○,20720.23,21121.18
2011/8/16,24276,●,楽天,涌井,224,西武ドーム,2011,8,16,火,0.0,29.1,4,8,12,-4,9,4,13,5,○,20720.23,20196.04
2011/8/17,17697,△,楽天,帆足,211,西武ドーム,2011,8,17,水,0.0,29.6,2,2,4,0,4,8,12,-4,●,20720.23,20806.97
2011/8/18,20293,○,楽天,菊池,170,西武ドーム,2011,8,18,木,0.0,30.9,6,1,7,5,2,2,4,0,△,20720.23,19713.64
2011/8/23,18160,○,オリックス,石井一,228,新潟,2011,8,23,火,0.0,23.2,11,5,16,6,6,1,7,5,○,20720.23,21263.5
2011/8/25,20418,●,オリックス,涌井,197,大宮,2011,8,25,木,22.5,24.3,0,2,2,-2,11,5,16,6,○,20720.23,19019.58
2011/8/26,19761,○,日本ハム,帆足,218,西武ドーム,2011,8,26,金,10.0,24.5,4,3,7,1,0,2,2,-2,●,20720.23,19753.74
2011/8/27,32282,●,日本ハム,岸,177,西武ドーム,2011,8,27,土,0.5,23.0,3,4,7,-1,4,3,7,1,○,20720.23,21138.49
2011/8/28,24256,○,日本ハム,西口,142,西武ドーム,2011,8,28,日,0.0,24.5,1,0,1,1,3,4,7,-1,●,20720.23,20998.5
2011/9/2,13013,○,ソフトバンク,帆足,171,西武ドーム,2011,9,2,金,6.5,27.1,5,3,8,2,1,0,1,1,○,20473.55,20570.03
2011/9/3,23159,●,ソフトバンク,岸,220,西武ドーム,2011,9,3,土,12.0,26.8,7,10,17,-3,5,3,8,2,○,20473.55,21970.81
2011/9/4,24508,○,ソフトバンク,西口,187,西武ドーム,2011,9,4,日,11.5,25.8,12,2,14,10,7,10,17,-3,●,20473.55,22697.37
2011/9/6,12173,○,ロッテ,石井一,179,西武ドーム,2011,9,6,火,7.5,22.8,5,1,6,4,12,2,14,10,○,20473.55,19710.77
2011/9/7,12994,●,ロッテ,涌井,176,西武ドーム,2011,9,7,水,0.0,23.2,0,2,2,-2,5,1,6,4,○,20473.55,18786.29
2011/9/8,13792,○,ロッテ,菊池,157,西武ドーム,2011,9,8,木,0.0,24.1,7,4,11,3,0,2,2,-2,●,20473.55,17143.54
2011/9/16,14414,○,楽天,帆足,203,西武ドーム,2011,9,16,金,1.5,26.4,6,5,11,1,7,4,11,3,○,20473.55,20196.04
2011/9/17,25624,○,楽天,岸,191,西武ドーム,2011,9,17,土,19.5,25.8,4,2,6,2,6,5,11,1,○,20473.55,20806.97
2011/9/18,26981,○,楽天,西口,190,西武ドーム,2011,9,18,日,0.0,26.8,2,1,3,1,4,2,6,2,○,20473.55,19713.64
2011/9/19,25321,○,日本ハム,石井一,179,西武ドーム,2011,9,19,月,1.5,24.5,7,5,12,2,2,1,3,1,○,20473.55,19628.91
2011/9/20,13521,○,日本ハム,涌井,201,西武ドーム,2011,9,20,火,22.0,18.1,5,4,9,1,7,5,12,2,○,20473.55,20765.17
2011/9/23,29672,○,ロッテ,帆足,178,西武ドーム,2011,9,23,金,0.5,17.9,6,4,10,2,5,4,9,1,○,20473.55,21263.5
2011/9/30,17154,●,ソフトバンク,西口,159,西武ドーム,2011,9,30,金,0.0,21.0,3,4,7,-1,6,4,10,2,○,20473.55,21898.1
2011/10/1,32414,●,ソフトバンク,岸,188,西武ドーム,2011,10,1,土,0.0,20.5,0,3,3,-3,3,4,7,-1,●,16821.42,22001.45
2011/10/2,29397,●,ソフトバンク,石井一,198,西武ドーム,2011,10,2,日,0.0,16.9,3,5,8,-2,0,3,3,-3,●,16821.42,20570.03
2011/10/4,16386,●,オリックス,涌井,202,西武ドーム,2011,10,4,火,0.0,16.5,3,5,8,-2,3,5,8,-2,●,16821.42,22697.37
2011/10/5,15195,○,オリックス,帆足,211,西武ドーム,2011,10,5,水,45.5,14.4,11,6,17,5,3,5,8,-2,●,16821.42,23356.53
2011/10/6,16398,○,オリックス,西口,161,西武ドーム,2011,10,6,木,1.5,19.2,2,1,3,1,11,6,17,5,○,16821.42,19710.77
2011/10/12,18693,○,ロッテ,西口,193,西武ドーム,2011,10,12,水,0.0,18.2,11,3,14,8,2,1,3,1,○,16821.42,20345.97
2011/10/15,33143,○,楽天,岸,172,西武ドーム,2011,10,15,土,31.0,19.6,6,3,9,3,11,3,14,8,○,16821.42,21160.21
2011/10/16,33916,△,ソフトバンク,涌井,226,西武ドーム,2011,10,16,日,5.5,22.0,4,4,8,0,6,3,9,3,○,16821.42,20196.04
2011/10/18,33913,○,日本ハム,西口,153,西武ドーム,2011,10,18,火,0.0,17.8,4,3,7,1,4,4,8,0,△,16821.42,19713.64
2012/4/4,21694,●,ロッテ,牧田,156,西武ドーム,2012,4,4,水,0.0,10.0,0,2,2,-2,4,3,7,1,○,17693.64,22697.37
2012/4/6,12833,●,ソフトバンク,西口,174,西武ドーム,2012,4,6,金,0.0,7.9,2,4,6,-2,0,2,2,-2,●,17693.64,19710.77
2012/4/7,24735,●,ソフトバンク,涌井,211,西武ドーム,2012,4,7,土,0.0,5.2,2,4,6,-2,2,4,6,-2,●,17693.64,18786.29
2012/4/8,21892,●,ソフトバンク,その他,226,西武ドーム,2012,4,8,日,0.0,7.4,5,7,12,-2,2,4,6,-2,●,17693.64,17143.54
2012/4/15,25460,●,オリックス,涌井,206,西武ドーム,2012,4,15,日,0.0,11.0,2,6,8,-4,5,7,12,-2,●,17693.64,21160.21
2012/4/16,12077,●,日本ハム,西口,191,西武ドーム,2012,4,16,月,0.0,11.0,0,13,13,-13,2,6,8,-4,●,17693.64,20196.04
2012/4/17,11335,○,日本ハム,牧田,162,西武ドーム,2012,4,17,火,0.0,12.5,3,2,5,1,0,13,13,-13,●,17693.64,20806.97
2012/4/19,14811,●,日本ハム,岸,199,皇子山,2012,4,19,木,0.5,12.6,2,3,5,-1,3,2,5,1,○,17693.64,19628.91
2012/5/1,14413,●,楽天,牧田,181,西武ドーム,2012,5,1,火,17.5,17.7,3,4,7,-1,2,3,5,-1,●,22741.88,22001.45
2012/5/2,15504,●,楽天,岸,220,西武ドーム,2012,5,2,水,59.5,16.5,2,12,14,-10,3,4,7,-1,●,22741.88,20570.03
2012/5/3,31357,○,楽天,その他,179,西武ドーム,2012,5,3,木,104.5,16.2,6,1,7,5,2,12,14,-10,●,22741.88,21970.81
2012/5/4,29556,●,ロッテ,その他,188,西武ドーム,2012,5,4,金,2.5,17.2,2,3,5,-1,6,1,7,5,○,22741.88,22697.37
2012/5/5,32076,●,ロッテ,野上,172,西武ドーム,2012,5,5,土,0.0,18.9,2,4,6,-2,2,3,5,-1,●,22741.88,23356.53
2012/5/6,26891,△,ロッテ,西口,222,西武ドーム,2012,5,6,日,2.0,16.6,4,4,8,0,2,4,6,-2,●,22741.88,19710.77
2012/5/22,24523,●,巨人,牧田,195,西武ドーム,2012,5,22,火,13.5,13.4,2,5,7,-3,4,4,8,0,△,22741.88,19673.16
2012/5/23,27868,●,巨人,岸,157,西武ドーム,2012,5,23,水,0.0,18.2,0,2,2,-2,2,5,7,-3,●,22741.88,21263.5
2012/5/25,14392,○,ヤクルト,その他,163,西武ドーム,2012,5,25,金,1.0,18.0,10,0,10,10,0,2,2,-2,●,22741.88,19019.58
2012/5/26,26752,○,ヤクルト,西口,160,西武ドーム,2012,5,26,土,0.0,19.4,8,0,8,8,10,0,10,10,○,22741.88,19753.74
2012/6/2,24696,○,DeNA,西口,181,西武ドーム,2012,6,2,土,0.5,19.8,7,4,11,3,8,0,8,8,○,22359.4,20570.03
2012/6/3,25722,●,DeNA,牧田,194,西武ドーム,2012,6,3,日,1.0,18.6,5,7,12,-2,7,4,11,3,○,22359.4,21970.81
2012/6/5,15691,○,中日,岸,177,西武ドーム,2012,6,5,火,0.0,19.5,7,4,11,3,5,7,12,-2,●,22359.4,23356.53
2012/6/6,15797,○,中日,その他,181,西武ドーム,2012,6,6,水,7.5,17.2,3,1,4,2,7,4,11,3,○,22359.4,19710.77
2012/6/13,26211,○,阪神,その他,151,西武ドーム,2012,6,13,水,1.0,16.4,2,0,2,2,3,1,4,2,○,22359.4,19970.56
2012/6/14,23634,●,阪神,西口,215,西武ドーム,2012,6,14,木,0.0,17.6,3,4,7,-1,2,0,2,2,○,22359.4,20046.41
2012/6/16,33901,○,広島,牧田,147,西武ドーム,2012,6,16,土,5.0,18.9,6,5,11,1,3,4,7,-1,●,22359.4,20196.04
2012/6/17,31520,●,広島,岸,245,西武ドーム,2012,6,17,日,4.0,22.0,4,11,15,-7,6,5,11,1,○,22359.4,20806.97
2012/6/22,20021,△,オリックス,その他,214,大宮,2012,6,22,金,40.5,20.0,3,3,6,0,4,11,15,-7,●,22359.4,19673.16
2012/6/23,19581,○,オリックス,西口,166,西武ドーム,2012,6,23,土,0.0,21.4,5,2,7,3,3,3,6,0,△,22359.4,21263.5
2012/6/24,21707,○,オリックス,牧田,203,西武ドーム,2012,6,24,日,0.5,21.4,4,3,7,1,5,2,7,3,○,22359.4,18457.52
2012/6/25,10122,●,オリックス,その他,211,西武ドーム,2012,6,25,月,0.0,17.0,3,5,8,-2,4,3,7,1,○,22359.4,19019.58
2012/6/29,13972,○,日本ハム,西口,201,西武ドーム,2012,6,29,金,0.0,22.4,7,5,12,2,3,5,8,-2,●,22359.4,22562.68
2012/6/30,24049,○,日本ハム,牧田,199,西武ドーム,2012,6,30,土,0.0,22.6,10,5,15,5,7,5,12,2,○,22359.4,21898.1
2012/7/1,29605,△,日本ハム,菊池,211,西武ドーム,2012,7,1,日,8.0,20.2,3,3,6,0,10,5,15,5,○,19106.44,22001.45
2012/7/6,13597,●,楽天,西口,179,西武ドーム,2012,7,6,金,16.0,23.6,2,6,8,-4,3,3,6,0,△,19106.44,19710.77
2012/7/7,25415,●,楽天,牧田,202,西武ドーム,2012,7,7,土,25.0,21.5,1,12,13,-11,2,6,8,-4,●,19106.44,18786.29
2012/7/8,27962,○,楽天,菊池,214,西武ドーム,2012,7,8,日,0.5,21.8,9,5,14,4,1,12,13,-11,●,19106.44,17143.54
2012/7/10,12505,○,ソフトバンク,野上,180,西武ドーム,2012,7,10,火,0.0,24.9,5,2,7,3,9,5,14,4,○,19106.44,17777.52
2012/7/11,13376,●,ソフトバンク,その他,180,西武ドーム,2012,7,11,水,0.0,25.8,1,4,5,-3,5,2,7,3,○,19106.44,21121.18
2012/7/12,12452,○,ソフトバンク,その他,147,西武ドーム,2012,7,12,木,5.5,24.9,2,0,2,2,1,4,5,-3,●,19106.44,20345.97
2012/7/25,18897,○,ロッテ,牧田,156,西武ドーム,2012,7,25,水,0.0,27.4,4,2,6,2,2,0,2,2,○,19106.44,19019.58
2012/7/26,17269,○,ロッテ,菊池,165,西武ドーム,2012,7,26,木,0.0,28.8,2,1,3,1,4,2,6,2,○,19106.44,19753.74
2012/7/30,16997,○,オリックス,岸,196,西武ドーム,2012,7,30,月,0.0,28.3,6,2,8,4,2,1,3,1,○,19106.44,21898.1
2012/7/31,18804,●,オリックス,その他,191,西武ドーム,2012,7,31,火,0.0,28.2,1,7,8,-6,6,2,8,4,○,19106.44,21679.45
2012/8/2,14047,△,オリックス,牧田,226,前橋,2012,8,2,木,0.0,28.4,1,1,2,0,1,7,8,-6,●,20720.23,20570.03
2012/8/10,15135,○,日本ハム,野上,184,西武ドーム,2012,8,10,金,0.0,26.0,7,1,8,6,1,1,2,0,△,20720.23,17777.52
2012/8/11,33910,●,日本ハム,その他,162,西武ドーム,2012,8,11,土,2.0,26.4,0,3,3,-3,7,1,8,6,○,20720.23,21121.18
2012/8/12,30412,○,日本ハム,その他,188,西武ドーム,2012,8,12,日,0.0,26.3,7,4,11,3,0,3,3,-3,●,20720.23,20345.97
2012/8/17,22333,○,楽天,野上,176,西武ドーム,2012,8,17,金,1.5,28.3,4,1,5,3,7,4,11,3,○,20720.23,20806.97
2012/8/18,28381,○,楽天,その他,223,西武ドーム,2012,8,18,土,0.5,26.3,6,5,11,1,4,1,5,3,○,20720.23,19713.64
2012/8/19,27482,○,楽天,その他,180,西武ドーム,2012,8,19,日,0.0,27.4,6,2,8,4,6,5,11,1,○,20720.23,19628.91
2012/8/21,17677,●,ソフトバンク,岸,175,西武ドーム,2012,8,21,火,0.0,27.7,0,4,4,-4,6,2,8,4,○,20720.23,20805.45
2012/8/22,17972,●,ソフトバンク,菊池,193,西武ドーム,2012,8,22,水,0.0,28.3,2,8,10,-6,0,4,4,-4,●,20720.23,19673.16
2012/8/23,20420,○,ソフトバンク,牧田,181,大宮,2012,8,23,木,0.0,28.3,5,2,7,3,2,8,10,-6,●,20720.23,21263.5
2012/8/31,20388,○,ロッテ,野上,179,西武ドーム,2012,8,31,金,0.0,27.8,5,3,8,2,5,2,7,3,○,20720.23,21679.45
2012/9/1,33916,○,ロッテ,その他,162,西武ドーム,2012,9,1,土,20.0,24.5,4,2,6,2,5,3,8,2,○,20473.55,22001.45
2012/9/2,27766,○,ロッテ,その他,192,西武ドーム,2012,9,2,日,58.5,23.3,2,1,3,1,4,2,6,2,○,20473.55,20570.03
2012/9/4,13318,●,ソフトバンク,岸,188,西武ドーム,2012,9,4,火,4.0,25.1,3,5,8,-2,2,1,3,1,○,20473.55,22697.37
2012/9/5,13959,○,ソフトバンク,菊池,156,西武ドーム,2012,9,5,水,0.0,26.4,2,1,3,1,3,5,8,-2,●,20473.55,23356.53
2012/9/6,14154,○,ソフトバンク,牧田,200,西武ドーム,2012,9,6,木,9.0,24.7,9,2,11,7,2,1,3,1,○,20473.55,19710.77
2012/9/11,11979,●,オリックス,岸,203,西武ドーム,2012,9,11,火,0.0,26.3,2,3,5,-1,9,2,11,7,○,20473.55,21121.18
2012/9/12,13945,○,オリックス,菊池,194,西武ドーム,2012,9,12,水,0.0,25.6,4,3,7,1,2,3,5,-1,●,20473.55,20345.97
2012/9/13,13673,○,オリックス,牧田,176,西武ドーム,2012,9,13,木,0.0,26.5,8,1,9,7,4,3,7,1,○,20473.55,19970.56
2012/9/21,20574,○,日本ハム,野上,164,西武ドーム,2012,9,21,金,17.5,22.8,4,2,6,2,8,1,9,7,○,20473.55,20805.45
2012/9/22,33913,○,日本ハム,その他,200,西武ドーム,2012,9,22,土,5.5,20.8,5,4,9,1,4,2,6,2,○,20473.55,19673.16
2012/9/23,33915,●,日本ハム,岸,214,西武ドーム,2012,9,23,日,85.5,18.8,2,6,8,-4,5,4,9,1,○,20473.55,21263.5
2012/9/25,17750,○,楽天,菊池,162,西武ドーム,2012,9,25,火,1.5,18.7,3,2,5,1,2,6,8,-4,●,20473.55,19019.58
2012/9/26,18902,●,楽天,牧田,196,西武ドーム,2012,9,26,水,0.0,20.1,2,3,5,-1,3,2,5,1,○,20473.55,19753.74
2012/9/27,17515,○,楽天,その他,177,西武ドーム,2012,9,27,木,0.0,19.9,3,1,4,2,2,3,5,-1,●,20473.55,21138.49
2012/9/30,28709,○,オリックス,牧田,167,西武ドーム,2012,9,30,日,35.0,23.8,4,3,7,1,3,1,4,2,○,20473.55,21898.1
2012/10/1,16582,●,ロッテ,菊池,179,西武ドーム,2012,10,1,月,0.0,25.3,0,4,4,-4,4,3,7,1,○,16821.42,22001.45
2012/10/2,18691,●,ロッテ,その他,178,西武ドーム,2012,10,2,火,0.0,22.1,3,5,8,-2,0,4,4,-4,●,16821.42,20570.03
2012/10/6,26938,○,ロッテ,岸,145,西武ドーム,2012,10,6,土,0.0,22.0,2,1,3,1,3,5,8,-2,●,16821.42,19710.77
2013/3/29,26750,●,日本ハム,岸,206,西武ドーム,2013,3,29,金,0.0,13.9,3,5,8,-2,2,1,3,1,○,23307.61,22562.68
2013/3/30,24585,○,日本ハム,菊池,199,西武ドーム,2013,3,30,土,2.0,6.6,4,2,6,2,3,5,8,-2,●,23307.61,21898.1
2013/3/31,22288,○,日本ハム,十亀,169,西武ドーム,2013,3,31,日,1.0,6.1,5,2,7,3,4,2,6,2,○,23307.61,21679.45
2013/4/2,12145,○,ソフトバンク,牧田,162,西武ドーム,2013,4,2,火,38.0,8.5,4,1,5,3,5,2,7,3,○,17693.64,20570.03
2013/4/3,11517,○,ソフトバンク,野上,170,西武ドーム,2013,4,3,水,34.5,11.9,6,2,8,4,4,1,5,3,○,17693.64,21970.81
2013/4/4,13458,○,ソフトバンク,涌井,204,西武ドーム,2013,4,4,木,0.0,14.6,3,1,4,2,6,2,8,4,○,17693.64,22697.37
2013/4/16,11180,○,オリックス,牧田,171,西武ドーム,2013,4,16,火,0.0,13.5,10,1,11,9,3,1,4,2,○,17693.64,20196.04
2013/4/17,10553,●,オリックス,野上,179,西武ドーム,2013,4,17,水,0.0,17.7,1,2,3,-1,10,1,11,9,○,17693.64,20806.97
2013/4/18,15324,○,オリックス,涌井,222,大宮,2013,4,18,木,0.0,17.6,8,6,14,2,1,2,3,-1,●,17693.64,19713.64
2013/4/23,12611,○,ロッテ,牧田,170,西武ドーム,2013,4,23,火,0.0,11.2,8,0,8,8,8,6,14,2,○,17693.64,21263.5
2013/4/24,11785,○,ロッテ,野上,181,西武ドーム,2013,4,24,水,9.0,14.5,7,2,9,5,8,0,8,8,○,17693.64,18457.52
2013/4/25,12060,●,ロッテ,涌井,205,西武ドーム,2013,4,25,木,0.0,16.5,4,5,9,-1,7,2,9,5,○,17693.64,19019.58
2013/4/27,26556,●,楽天,岸,171,西武ドーム,2013,4,27,土,0.0,13.0,2,9,11,-7,4,5,9,-1,●,17693.64,21138.49
2013/4/28,28930,○,楽天,菊池,212,西武ドーム,2013,4,28,日,0.0,13.9,15,1,16,14,2,9,11,-7,●,17693.64,20998.5
2013/4/29,28092,○,楽天,十亀,181,西武ドーム,2013,4,29,月,0.0,14.5,8,4,12,4,15,1,16,14,○,17693.64,22562.68
2013/5/4,32596,○,日本ハム,岸,267,西武ドーム,2013,5,4,土,0.0,13.8,9,7,16,2,8,4,12,4,○,22741.88,22697.37
2013/5/5,33917,○,日本ハム,菊池,158,西武ドーム,2013,5,5,日,0.0,15.7,2,0,2,2,9,7,16,2,○,22741.88,23356.53
2013/5/6,27422,○,日本ハム,十亀,174,西武ドーム,2013,5,6,月,0.0,17.5,1,0,1,1,2,0,2,2,○,22741.88,19710.77
2013/5/19,33918,●,阪神,涌井,224,西武ドーム,2013,5,19,日,1.5,18.1,5,10,15,-5,1,0,1,1,○,22741.88,19628.91
2013/5/20,21882,○,阪神,菊池,174,西武ドーム,2013,5,20,月,1.5,17.8,5,1,6,4,5,10,15,-5,●,22741.88,20765.17
2013/5/22,17202,●,広島,牧田,199,西武ドーム,2013,5,22,水,0.0,21.2,0,1,1,-1,5,1,6,4,○,22741.88,19673.16
2013/5/23,16553,●,広島,野上,210,西武ドーム,2013,5,23,木,0.0,21.0,2,6,8,-4,0,1,1,-1,●,22741.88,21263.5
2013/5/31,15300,○,ヤクルト,牧田,185,西武ドーム,2013,5,31,金,0.0,21.7,4,1,5,3,2,6,8,-4,●,22741.88,21679.45
2013/6/1,28154,○,ヤクルト,岸,199,西武ドーム,2013,6,1,土,0.0,19.6,3,2,5,1,4,1,5,3,○,22359.4,22001.45
2013/6/2,33917,○,巨人,十亀,159,西武ドーム,2013,6,2,日,0.0,18.2,5,1,6,4,3,2,5,1,○,22359.4,20570.03
2013/6/3,33801,●,巨人,菊池,186,西武ドーム,2013,6,3,月,0.0,19.2,3,7,10,-4,5,1,6,4,○,22359.4,21970.81
2013/6/12,15993,○,中日,菊池,168,西武ドーム,2013,6,12,水,10.5,19.5,10,0,10,10,3,7,10,-4,●,22359.4,20345.97
2013/6/13,13786,●,中日,野上,235,西武ドーム,2013,6,13,木,56.0,20.4,3,4,7,-1,10,0,10,10,○,22359.4,19970.56
2013/6/15,30803,●,DeNA,牧田,225,西武ドーム,2013,6,15,土,11.5,24.6,2,7,9,-5,3,4,7,-1,●,22359.4,21160.21
2013/6/16,32992,○,DeNA,岸,187,西武ドーム,2013,6,16,日,24.0,22.5,7,1,8,6,2,7,9,-5,●,22359.4,20196.04
2013/6/21,20097,○,オリックス,菊池,205,西武ドーム,2013,6,21,金,6.5,20.2,2,0,2,2,7,1,8,6,○,22359.4,20805.45
2013/6/22,24895,●,オリックス,十亀,199,西武ドーム,2013,6,22,土,2.5,20.5,0,2,2,-2,2,0,2,2,○,22359.4,19673.16
2013/6/23,26689,△,オリックス,岸,329,西武ドーム,2013,6,23,日,0.0,21.8,9,9,18,0,0,2,2,-2,●,22359.4,21263.5
2013/6/25,14528,●,楽天,牧田,199,西武ドーム,2013,6,25,火,26.0,21.9,0,11,11,-11,9,9,18,0,△,22359.4,19019.58
2013/6/26,12707,○,楽天,野上,167,西武ドーム,2013,6,26,水,32.0,19.8,1,0,1,1,0,11,11,-11,●,22359.4,19753.74
2013/6/27,20051,●,楽天,涌井,211,大宮,2013,6,27,木,2.5,21.5,1,10,11,-9,1,0,1,1,○,22359.4,21138.49
2013/7/5,17567,○,ロッテ,菊池,208,西武ドーム,2013,7,5,金,0.0,25.7,7,2,9,5,1,10,11,-9,●,19106.44,23356.53
2013/7/6,31715,○,ロッテ,十亀,164,西武ドーム,2013,7,6,土,0.0,28.4,7,3,10,4,7,2,9,5,○,19106.44,19710.77
2013/7/7,30344,○,ロッテ,岸,180,西武ドーム,2013,7,7,日,1.0,27.7,11,2,13,9,7,3,10,4,○,19106.44,18786.29
2013/7/9,13317,●,ソフトバンク,牧田,208,西武ドーム,2013,7,9,火,0.0,28.1,4,5,9,-1,11,2,13,9,○,19106.44,18510.93
2013/7/10,13138,○,ソフトバンク,野上,190,西武ドーム,2013,7,10,水,0.0,28.9,3,2,5,1,4,5,9,-1,●,19106.44,17777.52
2013/7/24,17591,●,ロッテ,十亀,205,西武ドーム,2013,7,24,水,6.5,23.6,1,4,5,-3,3,2,5,1,○,19106.44,18457.52
2013/7/25,16154,○,ロッテ,野上,173,西武ドーム,2013,7,25,木,1.0,23.9,11,4,15,7,1,4,5,-3,●,19106.44,19019.58
2013/7/26,18612,○,オリックス,牧田,173,西武ドーム,2013,7,26,金,0.0,26.7,5,1,6,4,11,4,15,7,○,19106.44,19753.74
2013/7/27,29256,●,オリックス,涌井,211,西武ドーム,2013,7,27,土,22.0,25.5,2,7,9,-5,5,1,6,4,○,19106.44,21138.49
2013/7/28,27267,○,オリックス,岸,198,西武ドーム,2013,7,28,日,0.0,25.2,7,0,7,7,2,7,9,-5,●,19106.44,20998.5
2013/8/6,19146,●,日本ハム,菊池,213,西武ドーム,2013,8,6,火,2.0,26.2,1,13,14,-12,7,0,7,7,○,20720.23,19710.77
2013/8/7,18502,○,日本ハム,十亀,242,西武ドーム,2013,8,7,水,0.0,28.3,7,6,13,1,1,13,14,-12,●,20720.23,18786.29
2013/8/8,19087,●,日本ハム,西口,257,西武ドーム,2013,8,8,木,0.0,28.6,1,2,3,-1,7,6,13,1,○,20720.23,17143.54
2013/8/13,21685,●,ソフトバンク,涌井,276,西武ドーム,2013,8,13,火,14.0,28.0,5,9,14,-4,1,2,3,-1,●,20720.23,19970.56
2013/8/14,19865,●,ソフトバンク,十亀,185,西武ドーム,2013,8,14,水,0.0,28.2,3,11,14,-8,5,9,14,-4,●,20720.23,20046.41
2013/8/15,20519,●,ソフトバンク,西口,240,西武ドーム,2013,8,15,木,0.0,27.9,4,13,17,-9,3,11,14,-8,●,20720.23,21160.21
2013/8/16,29846,●,楽天,野上,180,西武ドーム,2013,8,16,金,0.0,28.3,1,3,4,-2,4,13,17,-9,●,20720.23,20196.04
2013/8/17,27382,○,楽天,牧田,185,西武ドーム,2013,8,17,土,0.0,27.9,3,2,5,1,1,3,4,-2,●,20720.23,20806.97
2013/8/18,21689,○,楽天,岸,257,西武ドーム,2013,8,18,日,0.0,28.6,12,11,23,1,3,2,5,1,○,20720.23,19713.64
2013/8/24,27680,●,ソフトバンク,牧田,202,西武ドーム,2013,8,24,土,0.0,26.5,3,7,10,-4,12,11,23,1,○,20720.23,18457.52
2013/8/25,23911,●,ソフトバンク,野上,210,西武ドーム,2013,8,25,日,5.0,23.5,2,5,7,-3,3,7,10,-4,●,20720.23,19019.58
2013/8/30,22150,●,オリックス,牧田,249,西武ドーム,2013,8,30,金,0.0,28.2,2,6,8,-4,2,5,7,-3,●,20720.23,21898.1
2013/8/31,26642,○,オリックス,野上,203,西武ドーム,2013,8,31,土,0.0,29.0,2,1,3,1,2,6,8,-4,●,20720.23,21679.45
2013/9/1,22761,●,オリックス,西口,184,西武ドーム,2013,9,1,日,6.0,28.0,1,7,8,-6,2,1,3,1,○,20473.55,22001.45
2013/9/14,25743,●,ロッテ,野上,249,西武ドーム,2013,9,14,土,0.0,26.2,6,9,15,-3,1,7,8,-6,●,20473.55,20046.41
2013/9/15,28641,○,ロッテ,その他,258,西武ドーム,2013,9,15,日,84.0,23.9,3,2,5,1,6,9,15,-3,●,20473.55,21160.21
2013/9/17,16378,○,日本ハム,岸,166,西武ドーム,2013,9,17,火,0.0,20.7,5,1,6,4,3,2,5,1,○,20473.55,20806.97
2013/9/18,18150,●,日本ハム,十亀,232,西武ドーム,2013,9,18,水,0.0,20.8,2,4,6,-2,5,1,6,4,○,20473.55,19713.64
2013/9/19,18389,○,日本ハム,牧田,172,西武ドーム,2013,9,19,木,0.0,21.4,5,1,6,4,2,4,6,-2,●,20473.55,19628.91
2013/9/24,19621,○,楽天,十亀,193,西武ドーム,2013,9,24,火,0.5,20.9,4,3,7,1,5,1,6,4,○,20473.55,18457.52
2013/9/25,20332,○,楽天,牧田,223,西武ドーム,2013,9,25,水,16.5,22.0,4,2,6,2,4,3,7,1,○,20473.55,19019.58
2013/9/26,27869,●,楽天,その他,226,西武ドーム,2013,9,26,木,0.0,20.9,3,4,7,-1,4,2,6,2,○,20473.55,19753.74
2013/9/29,33920,○,ロッテ,岸,269,西武ドーム,2013,9,29,日,0.0,19.8,6,5,11,1,3,4,7,-1,●,20473.55,22562.68
2013/10/2,24647,○,ソフトバンク,牧田,177,西武ドーム,2013,10,2,水,5.5,22.5,2,1,3,1,6,5,11,1,○,16821.42,20570.03
2013/10/3,24030,○,ソフトバンク,その他,222,西武ドーム,2013,10,3,木,0.0,22.4,5,4,9,1,2,1,3,1,○,16821.42,21970.81
2013/10/8,32258,○,ロッテ,牧田,196,西武ドーム,2013,10,8,火,0.0,23.0,10,2,12,8,5,4,9,1,○,16821.42,17143.54
2014/3/28,31819,●,楽天,岸,185,西武ドーム,2014,3,28,金,0.0,12.0,1,2,3,-1,10,2,12,8,○,23307.61,20998.5
2014/3/29,26916,●,楽天,菊池,171,西武ドーム,2014,3,29,土,0.0,14.1,2,5,7,-3,1,2,3,-1,●,23307.61,22562.68
2014/3/30,23672,●,楽天,その他,218,西武ドーム,2014,3,30,日,6.5,14.2,1,7,8,-6,2,5,7,-3,●,23307.61,21898.1
2014/4/8,11051,●,ソフトバンク,牧田,187,西武ドーム,2014,4,8,火,0.0,13.0,3,4,7,-1,1,7,8,-6,●,17693.64,17143.54
2014/4/9,10260,○,ソフトバンク,野上,202,西武ドーム,2014,4,9,水,0.0,13.2,6,3,9,3,3,4,7,-1,●,17693.64,18510.93
2014/4/10,9875,●,ソフトバンク,その他,211,西武ドーム,2014,4,10,木,0.0,14.0,3,13,16,-10,6,3,9,3,○,17693.64,17777.52
2014/4/15,17880,●,ロッテ,牧田,180,大宮,2014,4,15,火,0.0,14.2,2,3,5,-1,3,13,16,-10,●,17693.64,21160.21
2014/4/16,11727,●,ロッテ,野上,185,西武ドーム,2014,4,16,水,0.0,15.7,2,6,8,-4,2,3,5,-1,●,17693.64,20196.04
2014/4/17,10743,○,ロッテ,その他,224,西武ドーム,2014,4,17,木,0.0,15.0,13,4,17,9,2,6,8,-4,●,17693.64,20806.97
2014/4/18,10381,●,オリックス,岸,235,西武ドーム,2014,4,18,金,4.5,9.8,1,2,3,-1,13,4,17,9,○,17693.64,19713.64
2014/4/19,23152,○,オリックス,菊池,204,西武ドーム,2014,4,19,土,0.5,10.0,6,3,9,3,1,2,3,-1,●,17693.64,19628.91
2014/4/20,25814,●,オリックス,その他,184,西武ドーム,2014,4,20,日,0.5,8.9,1,2,3,-1,6,3,9,3,○,17693.64,20765.17
2014/4/29,27849,○,日本ハム,牧田,168,西武ドーム,2014,4,29,火,0.0,16.0,4,1,5,3,1,2,3,-1,●,17693.64,22562.68
2014/4/30,11901,●,日本ハム,野上,211,西武ドーム,2014,4,30,水,19.5,15.0,2,3,5,-1,4,1,5,3,○,17693.64,21898.1
2014/5/1,13178,●,日本ハム,その他,228,西武ドーム,2014,5,1,木,2.0,18.7,5,9,14,-4,2,3,5,-1,●,22741.88,22001.45
2014/5/5,32005,●,楽天,牧田,178,西武ドーム,2014,5,5,月,0.0,15.9,0,5,5,-5,5,9,14,-4,●,22741.88,23356.53
2014/5/6,27686,○,楽天,野上,186,西武ドーム,2014,5,6,火,0.5,12.7,4,1,5,3,0,5,5,-5,●,22741.88,19710.77
2014/5/20,29720,●,巨人,牧田,188,西武ドーム,2014,5,20,火,0.0,19.9,1,9,10,-8,4,1,5,3,○,22741.88,20765.17
2014/5/21,29297,●,巨人,菊池,230,西武ドーム,2014,5,21,水,39.0,16.0,3,4,7,-1,1,9,10,-8,●,22741.88,20805.45
2014/5/23,14690,●,ヤクルト,野上,194,西武ドーム,2014,5,23,金,0.0,16.7,4,8,12,-4,3,4,7,-1,●,22741.88,21263.5
2014/5/24,30476,○,ヤクルト,岸,212,西武ドーム,2014,5,24,土,0.0,19.0,12,8,20,4,4,8,12,-4,●,22741.88,18457.52
2014/5/31,27047,○,中日,岸,176,西武ドーム,2014,5,31,土,0.0,24.1,5,1,6,4,12,8,20,4,○,22741.88,21679.45
2014/6/1,28551,●,中日,野上,212,西武ドーム,2014,6,1,日,0.0,25.1,4,8,12,-4,5,1,6,4,○,22359.4,22001.45
2014/6/3,14024,●,DeNA,十亀,170,西武ドーム,2014,6,3,火,0.0,22.5,2,5,7,-3,4,8,12,-4,●,22359.4,21970.81
2014/6/4,14892,○,DeNA,牧田,159,西武ドーム,2014,6,4,水,0.0,22.7,1,0,1,1,2,5,7,-3,●,22359.4,22697.37
2014/6/12,19763,○,広島,牧田,179,西武ドーム,2014,6,12,木,34.0,20.5,5,4,9,1,1,0,1,1,○,22359.4,20345.97
2014/6/13,26737,○,広島,その他,179,西武ドーム,2014,6,13,金,4.5,22.1,7,0,7,7,5,4,9,1,○,22359.4,19970.56
2014/6/14,33851,○,阪神,菊池,159,西武ドーム,2014,6,14,土,0.0,22.3,3,2,5,1,7,0,7,7,○,22359.4,20046.41
2014/6/15,33901,●,阪神,野上,195,西武ドーム,2014,6,15,日,0.0,22.7,1,8,9,-7,3,2,5,1,○,22359.4,21160.21
2014/6/27,18749,○,ソフトバンク,牧田,161,西武ドーム,2014,6,27,金,0.5,22.4,3,1,4,2,1,8,9,-7,●,22359.4,21138.49
2014/6/28,31447,○,ソフトバンク,野上,200,西武ドーム,2014,6,28,土,17.0,21.0,8,6,14,2,3,1,4,2,○,22359.4,20998.5
2014/6/29,30674,●,ソフトバンク,十亀,193,西武ドーム,2014,6,29,日,46.0,22.0,3,7,10,-4,8,6,14,2,○,22359.4,22562.68
2014/7/1,11926,●,日本ハム,岸,208,西武ドーム,2014,7,1,火,0.0,23.6,2,4,6,-2,3,7,10,-4,●,19106.44,22001.45
2014/7/2,16744,○,日本ハム,菊池,251,西武ドーム,2014,7,2,水,0.0,24.2,6,5,11,1,2,4,6,-2,●,19106.44,20570.03
2014/7/3,17095,●,日本ハム,その他,226,大宮,2014,7,3,木,1.0,22.9,3,8,11,-5,6,5,11,1,○,19106.44,21970.81
2014/7/8,11537,○,ロッテ,岸,249,西武ドーム,2014,7,8,火,0.0,24.7,5,4,9,1,3,8,11,-5,●,19106.44,17143.54
2014/7/9,11425,○,ロッテ,その他,197,西武ドーム,2014,7,9,水,10.5,22.3,10,5,15,5,5,4,9,1,○,19106.44,18510.93
2014/7/10,9816,●,ロッテ,その他,218,西武ドーム,2014,7,10,木,1.0,24.4,6,7,13,-1,10,5,15,5,○,19106.44,17777.52
2014/7/11,11982,○,オリックス,その他,251,西武ドーム,2014,7,11,金,0.5,27.5,2,1,3,1,6,7,13,-1,●,19106.44,21121.18
2014/7/12,25933,●,オリックス,牧田,232,西武ドーム,2014,7,12,土,6.0,26.6,2,3,5,-1,2,1,3,1,○,19106.44,20345.97
2014/7/13,23806,○,オリックス,菊池,231,西武ドーム,2014,7,13,日,0.0,24.5,6,5,11,1,2,3,5,-1,●,19106.44,19970.56
2014/7/21,22951,●,楽天,牧田,233,西武ドーム,2014,7,21,月,0.0,23.7,8,9,17,-1,6,5,11,1,○,19106.44,20805.45
2014/7/22,14041,○,楽天,菊池,182,西武ドーム,2014,7,22,火,0.0,26.1,2,0,2,2,8,9,17,-1,●,19106.44,19673.16
2014/7/23,14423,○,楽天,その他,234,西武ドーム,2014,7,23,水,0.0,27.4,2,1,3,1,2,0,2,2,○,19106.44,21263.5
2014/7/25,19222,●,ロッテ,その他,198,西武ドーム,2014,7,25,金,0.0,28.8,2,3,5,-1,2,1,3,1,○,19106.44,19019.58
2014/7/26,28994,○,ロッテ,その他,202,西武ドーム,2014,7,26,土,0.0,29.0,5,3,8,2,2,3,5,-1,●,19106.44,19753.74
2014/7/27,25968,●,ロッテ,岸,203,西武ドーム,2014,7,27,日,15.5,28.0,3,5,8,-2,5,3,8,2,○,19106.44,21138.49
2014/8/5,14104,●,ソフトバンク,牧田,207,西武ドーム,2014,8,5,火,0.0,31.0,3,11,14,-8,3,5,8,-2,●,20720.23,23356.53
2014/8/6,14245,●,ソフトバンク,菊池,202,西武ドーム,2014,8,6,水,0.0,30.7,1,8,9,-7,3,11,14,-8,●,20720.23,19710.77
2014/8/7,17964,●,ソフトバンク,その他,191,大宮,2014,8,7,木,0.0,29.0,1,2,3,-1,1,8,9,-7,●,20720.23,18786.29
2014/8/12,17905,●,オリックス,牧田,278,西武ドーム,2014,8,12,火,6.0,23.0,4,7,11,-3,1,2,3,-1,●,20720.23,20345.97
2014/8/13,17982,△,オリックス,菊池,236,西武ドーム,2014,8,13,水,0.0,24.3,0,0,0,0,4,7,11,-3,●,20720.23,19970.56
2014/8/14,17879,●,オリックス,その他,235,西武ドーム,2014,8,14,木,3.5,25.1,4,9,13,-5,0,0,0,0,△,20720.23,20046.41
2014/8/15,22407,○,日本ハム,野上,180,西武ドーム,2014,8,15,金,0.0,28.1,3,1,4,2,4,9,13,-5,●,20720.23,21160.21
2014/8/16,28374,△,日本ハム,その他,348,西武ドーム,2014,8,16,土,2.0,25.7,8,8,16,0,3,1,4,2,○,20720.23,20196.04
2014/8/17,28544,△,日本ハム,その他,314,西武ドーム,2014,8,17,日,0.0,23.8,3,3,6,0,8,8,16,0,△,20720.23,20806.97
2014/8/29,15818,○,オリックス,菊池,201,西武ドーム,2014,8,29,金,0.5,22.1,5,2,7,3,3,3,6,0,△,20720.23,22562.68
2014/8/30,28272,●,オリックス,野上,203,西武ドーム,2014,8,30,土,10.5,22.0,1,15,16,-14,5,2,7,3,○,20720.23,21898.1
2014/8/31,20244,○,オリックス,岸,198,西武ドーム,2014,8,31,日,0.0,22.4,6,5,11,1,1,15,16,-14,●,20720.23,21679.45
2014/9/2,12270,●,ロッテ,牧田,170,西武ドーム,2014,9,2,火,1.0,23.4,3,4,7,-1,6,5,11,1,○,20473.55,20570.03
2014/9/3,13504,●,ロッテ,その他,165,西武ドーム,2014,9,3,水,0.0,23.0,1,6,7,-5,3,4,7,-1,●,20473.55,21970.81
2014/9/4,12060,○,ロッテ,その他,165,西武ドーム,2014,9,4,木,0.0,23.0,4,1,5,3,1,6,7,-5,●,20473.55,22697.37
2014/9/13,25130,●,楽天,その他,222,西武ドーム,2014,9,13,土,0.0,21.1,3,8,11,-5,4,1,5,3,○,20473.55,19970.56
2014/9/14,33302,○,楽天,野上,165,西武ドーム,2014,9,14,日,0.0,21.4,11,2,13,9,3,8,11,-5,●,20473.55,20046.41
2014/9/15,24726,○,楽天,岸,203,西武ドーム,2014,9,15,月,0.0,21.2,9,1,10,8,11,2,13,9,○,20473.55,21160.21
2014/9/16,14497,○,日本ハム,菊池,197,西武ドーム,2014,9,16,火,0.0,23.1,6,0,6,6,9,1,10,8,○,20473.55,20196.04
2014/9/17,15007,●,日本ハム,その他,183,西武ドーム,2014,9,17,水,0.0,21.6,0,5,5,-5,6,0,6,6,○,20473.55,20806.97
2014/9/19,16328,○,ソフトバンク,牧田,192,西武ドーム,2014,9,19,金,0.0,19.2,6,3,9,3,0,5,5,-5,●,20473.55,19628.91
2014/9/20,26679,○,ソフトバンク,その他,269,西武ドーム,2014,9,20,土,0.0,17.7,6,5,11,1,6,3,9,3,○,20473.55,20765.17
2014/9/21,29431,●,ソフトバンク,野上,198,西武ドーム,2014,9,21,日,0.0,19.2,1,3,4,-2,6,5,11,1,○,20473.55,20805.45
2014/9/28,27991,●,楽天,その他,243,西武ドーム,2014,9,28,日,0.0,20.1,5,6,11,-1,1,3,4,-2,●,20473.55,20998.5
2014/10/2,28111,○,日本ハム,牧田,229,西武ドーム,2014,10,2,木,0.0,19.8,9,8,17,1,5,6,11,-1,●,16821.42,20570.03
2015/3/27,28210,○,オリックス,牧田,155,西武ドーム,2015,3,27,金,0.0,10.1,1,0,1,1,9,8,17,1,○,23307.61,21138.49
2015/3/28,24249,○,オリックス,野上,158,西武ドーム,2015,3,28,土,0.0,11.9,2,0,2,2,1,0,1,1,○,23307.61,20998.5
2015/3/29,26507,○,オリックス,その他,216,西武ドーム,2015,3,29,日,0.0,12.2,5,4,9,1,2,0,2,2,○,23307.61,22562.68
2015/4/3,13176,●,ソフトバンク,牧田,189,西武ドーム,2015,4,3,金,0.0,15.2,3,7,10,-4,5,4,9,1,○,17693.64,21970.81
2015/4/4,21734,●,ソフトバンク,野上,166,西武ドーム,2015,4,4,土,0.0,12.6,0,2,2,-2,3,7,10,-4,●,17693.64,22697.37
2015/4/5,21291,○,ソフトバンク,その他,147,西武ドーム,2015,4,5,日,3.5,9.3,4,0,4,4,0,2,2,-2,●,17693.64,23356.53
2015/4/11,22729,○,ロッテ,牧田,155,西武ドーム,2015,4,11,土,5.0,10.9,2,1,3,1,4,0,4,4,○,17693.64,21121.18
2015/4/12,26673,●,ロッテ,その他,184,西武ドーム,2015,4,12,日,0.0,11.5,5,9,14,-4,2,1,3,1,○,17693.64,20345.97
2015/4/14,9413,●,楽天,十亀,200,西武ドーム,2015,4,14,火,14.5,11.6,1,2,3,-1,5,9,14,-4,●,17693.64,20046.41
2015/4/15,9910,○,楽天,その他,185,西武ドーム,2015,4,15,水,1.5,13.7,14,2,16,12,1,2,3,-1,●,17693.64,21160.21
2015/4/16,14966,○,楽天,野上,190,大宮,2015,4,16,木,0.0,13.9,8,4,12,4,14,2,16,12,○,17693.64,20196.04
2015/4/21,11417,○,日本ハム,十亀,163,西武ドーム,2015,4,21,火,0.0,16.6,6,2,8,4,8,4,12,4,○,17693.64,20805.45
2015/4/22,11932,●,日本ハム,その他,172,西武ドーム,2015,4,22,水,0.5,14.9,1,5,6,-4,6,2,8,4,○,17693.64,19673.16
2015/5/4,31898,○,オリックス,菊池,210,西武ドーム,2015,5,4,月,0.0,20.6,10,6,16,4,1,5,6,-4,●,22741.88,22697.37
2015/5/5,28743,○,オリックス,十亀,184,西武ドーム,2015,5,5,火,0.0,17.8,6,1,7,5,10,6,16,4,○,22741.88,23356.53
2015/5/6,26634,○,オリックス,その他,191,西武ドーム,2015,5,6,水,0.0,16.4,11,6,17,5,6,1,7,5,○,22741.88,19710.77
2015/5/19,12881,○,ロッテ,十亀,203,西武ドーム,2015,5,19,火,2.5,18.7,3,2,5,1,11,6,17,5,○,22741.88,19628.91
2015/5/20,12827,●,ロッテ,野上,188,西武ドーム,2015,5,20,水,0.0,21.8,6,7,13,-1,3,2,5,1,○,22741.88,20765.17
2015/5/21,11277,●,ロッテ,その他,204,西武ドーム,2015,5,21,木,12.0,18.3,6,10,16,-4,6,7,13,-1,●,22741.88,20805.45
2015/5/22,12671,●,楽天,牧田,172,西武ドーム,2015,5,22,金,0.0,18.6,1,6,7,-5,6,10,16,-4,●,22741.88,19673.16
2015/5/23,27789,○,楽天,菊池,197,西武ドーム,2015,5,23,土,0.0,20.5,4,2,6,2,1,6,7,-5,●,22741.88,21263.5
2015/5/24,24695,●,楽天,その他,211,西武ドーム,2015,5,24,日,0.0,20.7,3,5,8,-2,4,2,6,2,○,22741.88,18457.52
2015/5/29,22333,●,阪神,牧田,174,西武ドーム,2015,5,29,金,6.5,19.6,0,1,1,-1,3,5,8,-2,●,22741.88,22562.68
2015/5/30,32698,○,阪神,菊池,199,西武ドーム,2015,5,30,土,0.0,23.0,9,2,11,7,0,1,1,-1,●,22741.88,21898.1
2015/5/31,32985,○,阪神,その他,225,西武ドーム,2015,5,31,日,0.0,24.2,9,4,13,5,9,2,11,7,○,22741.88,21679.45
2015/6/9,22284,○,広島,十亀,193,西武ドーム,2015,6,9,火,23.0,19.2,4,2,6,2,9,4,13,5,○,22359.4,18510.93
2015/6/10,22167,●,広島,野上,240,西武ドーム,2015,6,10,水,0.0,22.0,4,8,12,-4,4,2,6,2,○,22359.4,17777.52
2015/6/11,20867,○,広島,岸,214,西武ドーム,2015,6,11,木,0.0,21.8,5,4,9,1,4,8,12,-4,●,22359.4,21121.18
2015/6/12,15427,●,ヤクルト,牧田,173,西武ドーム,2015,6,12,金,2.5,21.1,3,9,12,-6,5,4,9,1,○,22359.4,20345.97
2015/6/13,32876,○,ヤクルト,菊池,191,西武ドーム,2015,6,13,土,0.0,23.7,6,4,10,2,3,9,12,-6,●,22359.4,19970.56
2015/6/14,31517,○,ヤクルト,その他,180,西武ドーム,2015,6,14,日,0.5,22.0,3,2,5,1,6,4,10,2,○,22359.4,20046.41
2015/6/23,17857,●,ソフトバンク,牧田,155,大宮,2015,6,23,火,0.0,22.4,2,3,5,-1,3,2,5,1,○,22359.4,21263.5
2015/6/24,14202,○,ソフトバンク,野上,220,西武ドーム,2015,6,24,水,0.0,23.3,7,4,11,3,2,3,5,-1,●,22359.4,18457.52
2015/6/25,13481,●,ソフトバンク,その他,201,西武ドーム,2015,6,25,木,6.0,22.5,6,9,15,-3,7,4,11,3,○,22359.4,19019.58
2015/6/26,15940,○,日本ハム,岸,198,西武ドーム,2015,6,26,金,10.5,20.9,12,4,16,8,6,9,15,-3,●,22359.4,19753.74
2015/6/27,32062,○,日本ハム,十亀,210,西武ドーム,2015,6,27,土,1.5,21.1,9,3,12,6,12,4,16,8,○,22359.4,21138.49
2015/6/28,30976,●,日本ハム,菊池,180,西武ドーム,2015,6,28,日,0.0,22.7,0,2,2,-2,9,3,12,6,○,22359.4,20998.5
2015/7/3,17457,△,ロッテ,岸,275,西武ドーム,2015,7,3,金,54.5,21.0,5,5,10,0,0,2,2,-2,●,19106.44,21970.81
2015/7/4,31041,○,ロッテ,十亀,186,西武ドーム,2015,7,4,土,4.0,21.6,8,2,10,6,5,5,10,0,△,19106.44,22697.37
2015/7/5,32453,○,ロッテ,菊池,163,西武ドーム,2015,7,5,日,7.0,19.9,3,1,4,2,8,2,10,6,○,19106.44,23356.53
2015/7/7,12154,○,オリックス,牧田,162,西武ドーム,2015,7,7,火,0.5,20.8,1,0,1,1,3,1,4,2,○,19106.44,18786.29
2015/7/8,12817,●,オリックス,野上,228,西武ドーム,2015,7,8,水,7.0,21.5,6,12,18,-6,1,0,1,1,○,19106.44,17143.54
2015/7/14,13212,○,楽天,牧田,194,西武ドーム,2015,7,14,火,0.0,29.4,5,2,7,3,6,12,18,-6,●,19106.44,20046.41
2015/7/15,18329,●,楽天,野上,254,西武ドーム,2015,7,15,水,0.0,27.2,4,7,11,-3,5,2,7,3,○,19106.44,21160.21
2015/7/24,23533,●,日本ハム,十亀,247,西武ドーム,2015,7,24,金,0.0,27.6,6,13,19,-7,4,7,11,-3,●,19106.44,18457.52
2015/7/25,30996,●,日本ハム,野上,222,西武ドーム,2015,7,25,土,0.0,28.7,4,6,10,-2,6,13,19,-7,●,19106.44,19019.58
2015/7/26,28284,●,日本ハム,牧田,238,西武ドーム,2015,7,26,日,0.0,30.1,3,8,11,-5,4,6,10,-2,●,19106.44,19753.74
2015/7/31,26071,●,ソフトバンク,十亀,208,西武ドーム,2015,7,31,金,0.0,28.8,2,4,6,-2,3,8,11,-5,●,19106.44,21679.45
2015/8/1,32732,●,ソフトバンク,野上,194,西武ドーム,2015,8,1,土,0.0,29.3,1,2,3,-1,2,4,6,-2,●,20720.23,22001.45
2015/8/2,31453,●,ソフトバンク,その他,205,西武ドーム,2015,8,2,日,0.0,28.7,3,4,7,-1,1,2,3,-1,●,20720.23,20570.03
2015/8/11,27169,○,日本ハム,岸,142,西武ドーム,2015,8,11,火,0.0,28.6,2,1,3,1,3,4,7,-1,●,20720.23,21121.18
2015/8/12,25661,●,日本ハム,菊池,200,西武ドーム,2015,8,12,水,5.0,26.7,3,6,9,-3,2,1,3,1,○,20720.23,20345.97
2015/8/13,27219,●,日本ハム,その他,253,西武ドーム,2015,8,13,木,0.5,26.3,8,11,19,-3,3,6,9,-3,●,20720.23,19970.56
2015/8/18,17984,○,楽天,岸,187,大宮,2015,8,18,火,0.0,27.1,1,0,1,1,8,11,19,-3,●,20720.23,19713.64
2015/8/19,18198,○,楽天,菊池,178,西武ドーム,2015,8,19,水,0.0,27.3,6,1,7,5,1,0,1,1,○,20720.23,19628.91
2015/8/20,17355,○,楽天,その他,206,西武ドーム,2015,8,20,木,27.0,24.6,15,7,22,8,6,1,7,5,○,20720.23,20765.17
2015/8/21,20506,○,ロッテ,十亀,202,西武ドーム,2015,8,21,金,0.0,25.1,7,6,13,1,15,7,22,8,○,20720.23,20805.45
2015/8/22,29236,●,ロッテ,野上,229,西武ドーム,2015,8,22,土,0.0,27.6,5,9,14,-4,7,6,13,1,○,20720.23,19673.16
2015/8/23,25631,○,ロッテ,その他,155,西武ドーム,2015,8,23,日,2.5,24.6,7,0,7,7,5,9,14,-4,●,20720.23,21263.5
2015/9/1,17981,○,ソフトバンク,岸,189,西武ドーム,2015,9,1,火,8.0,22.6,13,3,16,10,7,0,7,7,○,20473.55,22001.45
2015/9/2,17676,●,ソフトバンク,その他,313,西武ドーム,2015,9,2,水,3.0,25.8,4,5,9,-1,13,3,16,10,○,20473.55,20570.03
2015/9/3,17875,●,ソフトバンク,牧田,201,西武ドーム,2015,9,3,木,1.0,24.0,1,10,11,-9,4,5,9,-1,●,20473.55,21970.81
2015/9/8,16207,○,オリックス,岸,179,西武ドーム,2015,9,8,火,67.5,19.0,3,1,4,2,1,10,11,-9,●,20473.55,17143.54
2015/9/9,13556,●,オリックス,牧田,166,西武ドーム,2015,9,9,水,106.0,21.2,0,4,4,-4,3,1,4,2,○,20473.55,18510.93
2015/9/12,32724,○,日本ハム,十亀,294,西武ドーム,2015,9,12,土,0.0,23.4,9,8,17,1,0,4,4,-4,●,20473.55,20345.97
2015/9/13,32730,●,ロッテ,菊池,215,西武ドーム,2015,9,13,日,0.0,22.1,4,5,9,-1,9,8,17,1,○,20473.55,19970.56
2015/9/21,30167,○,オリックス,十亀,205,西武ドーム,2015,9,21,月,0.0,21.0,7,0,7,7,4,5,9,-1,●,20473.55,20805.45
2015/9/22,28017,○,オリックス,菊池,195,西武ドーム,2015,9,22,火,0.0,21.8,5,2,7,3,7,0,7,7,○,20473.55,19673.16
2015/9/23,24076,○,オリックス,野上,191,西武ドーム,2015,9,23,水,0.0,21.1,8,4,12,4,5,2,7,3,○,20473.55,21263.5
2015/9/26,21032,○,楽天,その他,160,西武ドーム,2015,9,26,土,2.0,20.1,5,1,6,4,8,4,12,4,○,20473.55,19753.74
2015/9/27,23013,○,楽天,十亀,176,西武ドーム,2015,9,27,日,0.0,20.8,5,1,6,4,5,1,6,4,○,20473.55,21138.49
2015/9/28,32988,●,ロッテ,菊池,189,西武ドーム,2015,9,28,月,0.0,22.3,2,4,6,-2,5,1,6,4,○,20473.55,20998.5
2016/3/25,32364,○,オリックス,菊池,221,西武ドーム,2016,3,25,金,0.0,5.8,5,4,9,1,2,4,6,-2,●,23307.61,19019.58
2016/3/26,32592,○,オリックス,十亀,218,西武ドーム,2016,3,26,土,0.0,7.2,9,5,14,4,5,4,9,1,○,23307.61,19753.74
2016/3/27,32689,●,オリックス,その他,247,西武ドーム,2016,3,27,日,0.0,9.5,4,5,9,-1,9,5,14,4,○,23307.61,21138.49
2016/4/5,13913,○,日本ハム,岸,147,西武ドーム,2016,4,5,火,2.5,9.5,10,0,10,10,4,5,9,-1,●,17693.64,23356.53
2016/4/6,13061,○,日本ハム,野上,188,西武ドーム,2016,4,6,水,0.0,13.2,5,2,7,3,10,0,10,10,○,17693.64,19710.77
2016/4/12,12358,●,ソフトバンク,岸,194,西武ドーム,2016,4,12,火,0.0,9.3,1,4,5,-3,5,2,7,3,○,17693.64,20345.97
2016/4/13,15262,●,ソフトバンク,野上,218,県営大宮,2016,4,13,水,0.5,12.8,1,5,6,-4,1,4,5,-3,●,17693.64,19970.56
2016/4/22,12635,●,楽天,十亀,242,西武ドーム,2016,4,22,金,0.0,16.7,7,8,15,-1,1,5,6,-4,●,17693.64,19673.16
2016/4/23,28903,△,楽天,その他,293,西武ドーム,2016,4,23,土,0.0,16.4,8,8,16,0,7,8,15,-1,●,17693.64,21263.5
2016/4/24,26845,○,楽天,岸,195,西武ドーム,2016,4,24,日,3.5,14.6,7,6,13,1,8,8,16,0,△,17693.64,18457.52
2016/4/26,12843,●,ロッテ,野上,161,西武ドーム,2016,4,26,火,0.0,17.5,2,5,7,-3,7,6,13,1,○,17693.64,19753.74
2016/4/27,12940,●,ロッテ,菊池,205,西武ドーム,2016,4,27,水,0.5,16.6,2,7,9,-5,2,5,7,-3,●,17693.64,21138.49
2016/5/3,28812,●,オリックス,野上,180,西武ドーム,2016,5,3,火,0.0,19.0,6,7,13,-1,2,7,9,-5,●,22741.88,21970.81
2016/5/4,27609,○,オリックス,菊池,182,西武ドーム,2016,5,4,水,10.5,21.9,8,2,10,6,6,7,13,-1,●,22741.88,22697.37
2016/5/5,30224,●,オリックス,十亀,190,西武ドーム,2016,5,5,木,0.0,20.5,5,7,12,-2,8,2,10,6,○,22741.88,23356.53
2016/5/6,16394,●,日本ハム,その他,222,西武ドーム,2016,5,6,金,0.0,17.3,4,8,12,-4,5,7,12,-2,●,22741.88,19710.77
2016/5/7,26687,●,日本ハム,その他,228,西武ドーム,2016,5,7,土,0.0,21.2,6,8,14,-2,4,8,12,-4,●,22741.88,18786.29
2016/5/8,32556,○,日本ハム,野上,202,西武ドーム,2016,5,8,日,0.0,19.8,6,2,8,4,6,8,14,-2,●,22741.88,17143.54
2016/5/21,31621,○,ソフトバンク,多和田,243,西武ドーム,2016,5,21,土,0.0,18.6,4,3,7,1,6,2,8,4,○,22741.88,20805.45
2016/5/22,29241,●,ソフトバンク,野上,188,西武ドーム,2016,5,22,日,0.0,21.3,2,4,6,-2,4,3,7,1,○,22741.88,19673.16
2016/5/24,11530,○,楽天,その他,168,西武ドーム,2016,5,24,火,0.0,22.5,4,1,5,3,2,4,6,-2,●,22741.88,18457.52
2016/5/25,11912,○,楽天,菊池,155,西武ドーム,2016,5,25,水,0.0,21.0,7,0,7,7,4,1,5,3,○,22741.88,19019.58
2016/5/26,17699,○,楽天,その他,186,県営大宮,2016,5,26,木,0.0,22.1,4,0,4,4,7,0,7,7,○,22741.88,19753.74
2016/5/31,14106,●,DeNA,その他,202,西武ドーム,2016,5,31,火,0.0,19.3,2,5,7,-3,4,0,4,4,○,22741.88,21679.45
2016/6/1,16793,○,DeNA,菊池,169,西武ドーム,2016,6,1,水,0.0,20.3,7,0,7,7,2,5,7,-3,●,22359.4,22001.45
2016/6/2,14224,○,DeNA,その他,176,西武ドーム,2016,6,2,木,0.0,19.2,4,1,5,3,7,0,7,7,○,22359.4,20570.03
2016/6/7,26391,○,巨人,菊池,205,西武ドーム,2016,6,7,火,0.0,18.2,6,2,8,4,4,1,5,3,○,22359.4,18786.29
2016/6/8,29018,●,巨人,その他,194,西武ドーム,2016,6,8,水,1.0,21.4,5,7,12,-2,6,2,8,4,○,22359.4,17143.54
2016/6/9,26124,○,巨人,その他,202,西武ドーム,2016,6,9,木,2.5,20.5,7,4,11,3,5,7,12,-2,●,22359.4,18510.93
2016/6/10,16080,○,中日,多和田,214,西武ドーム,2016,6,10,金,0.0,23.3,1,0,1,1,7,4,11,3,○,22359.4,17777.52
2016/6/11,32627,●,中日,その他,167,西武ドーム,2016,6,11,土,0.0,22.5,2,4,6,-2,1,0,1,1,○,22359.4,21121.18
2016/6/12,31546,○,中日,野上,183,西武ドーム,2016,6,12,日,0.5,22.8,3,2,5,1,2,4,6,-2,●,22359.4,20345.97
2016/6/24,15766,●,ロッテ,その他,203,前橋,2016,6,24,金,1.5,21.6,6,7,13,-1,3,2,5,1,○,22359.4,18457.52
2016/6/25,31519,○,ロッテ,野上,286,西武ドーム,2016,6,25,土,0.0,23.0,10,9,19,1,6,7,13,-1,●,22359.4,19019.58
2016/6/26,32153,●,ロッテ,多和田,221,西武ドーム,2016,6,26,日,0.0,23.7,4,10,14,-6,10,9,19,1,○,22359.4,19753.74
2016/7/8,13858,○,オリックス,その他,212,西武ドーム,2016,7,8,金,0.0,24.2,8,4,12,4,4,10,14,-6,●,19106.44,17143.54
2016/7/9,28541,●,オリックス,野上,171,西武ドーム,2016,7,9,土,3.5,21.7,0,2,2,-2,8,4,12,4,○,19106.44,18510.93
2016/7/10,27093,●,オリックス,多和田,212,西武ドーム,2016,7,10,日,0.0,24.8,2,8,10,-6,0,2,2,-2,●,19106.44,17777.52
2016/7/11,12268,○,楽天,岸,189,西武ドーム,2016,7,11,月,0.0,26.3,3,1,4,2,2,8,10,-6,●,19106.44,21121.18
2016/7/12,11397,●,楽天,その他,176,西武ドーム,2016,7,12,火,0.0,26.1,1,5,6,-4,3,1,4,2,○,19106.44,20345.97
2016/7/13,13147,●,楽天,その他,185,西武ドーム,2016,7,13,水,1.5,24.8,3,4,7,-1,1,5,6,-4,●,19106.44,19970.56
2016/7/18,32853,○,ロッテ,岸,170,西武ドーム,2016,7,18,月,0.0,27.7,6,1,7,5,3,4,7,-1,●,19106.44,19713.64
2016/7/19,14297,●,ロッテ,その他,203,西武ドーム,2016,7,19,火,0.0,27.1,2,9,11,-7,6,1,7,5,○,19106.44,19628.91
2016/7/26,19299,●,日本ハム,岸,193,西武ドーム,2016,7,26,火,4.0,22.6,1,4,5,-3,2,9,11,-7,●,19106.44,19753.74
2016/7/27,19757,●,日本ハム,その他,228,西武ドーム,2016,7,27,水,0.5,22.7,4,8,12,-4,1,4,5,-3,●,19106.44,21138.49
2016/7/28,19165,○,日本ハム,多和田,188,西武ドーム,2016,7,28,木,0.0,25.3,6,2,8,4,4,8,12,-4,●,19106.44,20998.5
2016/8/2,21963,●,ソフトバンク,岸,170,西武ドーム,2016,8,2,火,0.0,26.4,2,6,8,-4,6,2,8,4,○,20720.23,20570.03
2016/8/3,22185,●,ソフトバンク,その他,207,西武ドーム,2016,8,3,水,0.0,26.2,3,7,10,-4,2,6,8,-4,●,20720.23,21970.81
2016/8/4,20239,●,ソフトバンク,多和田,206,西武ドーム,2016,8,4,木,0.0,27.6,4,7,11,-3,3,7,10,-4,●,20720.23,22697.37
2016/8/12,23144,○,オリックス,菊池,199,西武ドーム,2016,8,12,金,0.0,25.8,8,3,11,5,4,7,11,-3,●,20720.23,20345.97
2016/8/13,25460,●,オリックス,十亀,157,西武ドーム,2016,8,13,土,0.0,26.2,1,9,10,-8,8,3,11,5,○,20720.23,19970.56
2016/8/14,32805,○,オリックス,その他,159,西武ドーム,2016,8,14,日,0.0,25.3,5,1,6,4,1,9,10,-8,●,20720.23,20046.41
2016/8/19,23052,○,ロッテ,菊池,179,西武ドーム,2016,8,19,金,0.0,27.1,5,3,8,2,5,1,6,4,○,20720.23,19628.91
2016/8/20,32779,○,ロッテ,十亀,226,西武ドーム,2016,8,20,土,48.0,24.6,10,4,14,6,5,3,8,2,○,20720.23,20765.17
2016/8/21,23260,●,ロッテ,その他,238,西武ドーム,2016,8,21,日,0.0,26.9,7,8,15,-1,10,4,14,6,○,20720.23,20805.45
2016/8/26,17979,○,日本ハム,菊池,185,県営大宮,2016,8,26,金,0.0,27.3,7,1,8,6,7,8,15,-1,●,20720.23,19753.74
2016/8/27,32524,●,日本ハム,その他,222,西武ドーム,2016,8,27,土,41.0,22.4,4,7,11,-3,7,1,8,6,○,20720.23,21138.49
2016/8/28,28370,○,日本ハム,その他,156,西武ドーム,2016,8,28,日,11.0,21.0,4,3,7,1,4,7,11,-3,●,20720.23,20998.5
2016/8/30,18832,●,ソフトバンク,岸,218,西武ドーム,2016,8,30,火,37.5,23.7,3,6,9,-3,4,3,7,1,○,20720.23,21898.1
2016/8/31,16408,○,ソフトバンク,多和田,267,西武ドーム,2016,8,31,水,0.0,24.9,8,7,15,1,3,6,9,-3,●,20720.23,21679.45
2016/9/1,15260,●,ソフトバンク,十亀,229,西武ドーム,2016,9,1,木,0.0,25.3,2,9,11,-7,8,7,15,1,○,20473.55,22001.45
2016/9/8,11039,●,ロッテ,その他,182,西武ドーム,2016,9,8,木,21.5,24.6,2,8,10,-6,2,9,11,-7,●,20473.55,17143.54
2016/9/9,22191,○,ロッテ,菊池,152,西武ドーム,2016,9,9,金,0.0,25.6,8,1,9,7,2,8,10,-6,●,20473.55,18510.93
2016/9/17,30512,○,楽天,菊池,188,西武ドーム,2016,9,17,土,0.0,24.3,3,1,4,2,8,1,9,7,○,20473.55,20806.97
2016/9/18,31564,●,楽天,その他,207,西武ドーム,2016,9,18,日,3.0,22.1,2,10,12,-8,3,1,4,2,○,20473.55,19713.64
2016/9/19,30117,○,楽天,多和田,176,西武ドーム,2016,9,19,月,18.0,20.3,5,2,7,3,2,10,12,-8,●,20473.55,19628.91
2016/9/23,15960,●,ソフトバンク,菊池,205,西武ドーム,2016,9,23,金,12.0,20.2,0,8,8,-8,5,2,7,3,○,20473.55,21263.5
2016/9/24,30234,●,ソフトバンク,その他,204,西武ドーム,2016,9,24,土,1.0,20.8,3,4,7,-1,0,8,8,-8,●,20473.55,18457.52
2016/9/25,28186,○,ソフトバンク,多和田,203,西武ドーム,2016,9,25,日,0.5,22.4,7,5,12,2,3,4,7,-1,●,20473.55,19019.58
2016/9/27,27158,○,日本ハム,岸,149,西武ドーム,2016,9,27,火,0.0,24.5,3,0,3,3,7,5,12,2,○,20473.55,21138.49
2016/9/28,28261,●,日本ハム,菊池,181,西武ドーム,2016,9,28,水,0.5,24.2,0,1,1,-1,3,0,3,3,○,20473.55,20998.5
2017/4/4,28935,●,オリックス,多和田,190,西武ドーム,2017,4,4,火,0.0,9.8,3,7,10,-4,0,1,1,-1,●,17693.64,22697.37
2017/4/5,15436,●,オリックス,その他,161,西武ドーム,2017,4,5,水,0.0,12.5,0,2,2,-2,3,7,10,-4,●,17693.64,23356.53
2017/4/7,12242,●,ソフトバンク,菊池,197,西武ドーム,2017,4,7,金,0.0,16.7,2,4,6,-2,0,2,2,-2,●,17693.64,18786.29
2017/4/8,29454,○,ソフトバンク,野上,164,西武ドーム,2017,4,8,土,3.5,13.8,6,1,7,5,2,4,6,-2,●,17693.64,17143.54
2017/4/9,32575,○,ソフトバンク,その他,163,西武ドーム,2017,4,9,日,2.5,13.0,4,2,6,2,6,1,7,5,○,17693.64,18510.93
2017/4/18,15757,●,楽天,その他,171,県営大宮,2017,4,18,火,16.5,18.1,0,2,2,-2,4,2,6,2,○,17693.64,19713.64
2017/4/19,11476,○,楽天,多和田,222,西武ドーム,2017,4,19,水,0.0,16.1,5,4,9,1,0,2,2,-2,●,17693.64,19628.91
2017/4/21,14326,○,日本ハム,菊池,181,西武ドーム,2017,4,21,金,0.0,14.0,9,0,9,9,5,4,9,1,○,17693.64,20805.45
2017/4/22,25134,○,日本ハム,野上,168,西武ドーム,2017,4,22,土,12.0,12.9,9,1,10,8,9,0,9,9,○,17693.64,19673.16
2017/4/23,30679,○,日本ハム,その他,187,西武ドーム,2017,4,23,日,0.0,12.9,12,3,15,9,9,1,10,8,○,17693.64,21263.5
2017/4/28,13443,△,ロッテ,菊池,239,西武ドーム,2017,4,28,金,0.0,14.4,2,2,4,0,12,3,15,9,○,17693.64,20998.5
2017/4/29,27839,●,ロッテ,野上,169,西武ドーム,2017,4,29,土,0.0,14.8,3,6,9,-3,2,2,4,0,△,17693.64,22562.68
2017/4/30,24288,○,ロッテ,その他,130,西武ドーム,2017,4,30,日,0.0,16.2,2,1,3,1,3,6,9,-3,●,17693.64,21898.1
2017/5/5,32598,○,楽天,菊池,174,西武ドーム,2017,5,5,金,0.0,18.3,7,1,8,6,2,1,3,1,○,22741.88,23356.53
2017/5/6,29264,●,楽天,野上,185,西武ドーム,2017,5,6,土,0.0,20.7,2,10,12,-8,7,1,8,6,○,22741.88,19710.77
2017/5/7,29528,●,楽天,その他,158,西武ドーム,2017,5,7,日,0.0,19.7,2,3,5,-1,2,10,12,-8,●,22741.88,18786.29
2017/5/19,15961,●,ソフトバンク,菊池,194,西武ドーム,2017,5,19,金,0.0,18.9,1,2,3,-1,2,3,5,-1,●,22741.88,19628.91
2017/5/20,31661,○,ソフトバンク,その他,207,西武ドーム,2017,5,20,土,0.0,21.4,7,5,12,2,1,2,3,-1,●,22741.88,20765.17
2017/5/21,26067,○,ソフトバンク,その他,193,西武ドーム,2017,5,21,日,0.0,22.8,7,6,13,1,7,5,12,2,○,22741.88,20805.45
2017/5/23,16470,○,日本ハム,野上,166,前橋,2017,5,23,火,0.0,21.6,2,0,2,2,7,6,13,1,○,22741.88,21263.5
2017/5/25,17307,○,日本ハム,十亀,194,県営大宮,2017,5,25,木,2.5,19.2,8,5,13,3,2,0,2,2,○,22741.88,19019.58
2017/5/30,22737,●,広島,野上,169,西武ドーム,2017,5,30,火,0.0,22.4,0,5,5,-5,8,5,13,3,○,22741.88,21898.1
2017/5/31,23523,●,広島,その他,217,西武ドーム,2017,5,31,水,0.0,22.9,4,9,13,-5,0,5,5,-5,●,22741.88,21679.45
2017/6/1,21564,○,広島,十亀,174,西武ドーム,2017,6,1,木,1.0,22.0,4,2,6,2,4,9,13,-5,●,22359.4,22001.45
2017/6/6,24533,○,巨人,野上,211,西武ドーム,2017,6,6,火,0.0,18.5,8,5,13,3,4,2,6,2,○,22359.4,19710.77
2017/6/7,25435,○,巨人,その他,157,西武ドーム,2017,6,7,水,0.0,19.3,3,0,3,3,8,5,13,3,○,22359.4,18786.29
2017/6/8,23626,○,巨人,十亀,153,西武ドーム,2017,6,8,木,0.0,21.5,13,2,15,11,3,0,3,3,○,22359.4,17143.54
2017/6/9,21390,●,DeNA,菊池,186,西武ドーム,2017,6,9,金,0.0,22.4,3,4,7,-1,13,2,15,11,○,22359.4,18510.93
2017/6/10,32627,○,DeNA,その他,188,西武ドーム,2017,6,10,土,0.0,23.0,6,2,8,4,3,4,7,-1,●,22359.4,17777.52
2017/6/11,32142,○,DeNA,その他,141,西武ドーム,2017,6,11,日,0.5,20.2,1,0,1,1,6,2,8,4,○,22359.4,21121.18
2017/6/28,14604,●,ロッテ,多和田,245,那覇,2017,6,28,水,5.5,22.2,3,4,7,-1,1,0,1,1,○,22359.4,20998.5
2017/6/30,23429,●,オリックス,菊池,190,西武ドーム,2017,6,30,金,4.5,22.6,0,3,3,-3,3,4,7,-1,●,22359.4,21898.1
2017/7/1,30065,●,オリックス,十亀,163,西武ドーム,2017,7,1,土,6.0,22.3,2,4,6,-2,0,3,3,-3,●,19106.44,22001.45
2017/7/2,30149,●,オリックス,その他,180,西武ドーム,2017,7,2,日,2.0,24.7,3,6,9,-3,2,4,6,-2,●,19106.44,20570.03
2017/7/10,13967,○,ロッテ,多和田,173,西武ドーム,2017,7,10,月,0.0,26.7,5,3,8,2,3,6,9,-3,●,19106.44,17777.52
2017/7/11,14047,○,ロッテ,野上,188,西武ドーム,2017,7,11,火,0.0,27.0,16,6,22,10,5,3,8,2,○,19106.44,21121.18
2017/7/12,15370,○,ロッテ,その他,181,西武ドーム,2017,7,12,水,0.0,28.2,6,3,9,3,16,6,22,10,○,19106.44,20345.97
2017/7/21,22857,○,日本ハム,菊池,194,西武ドーム,2017,7,21,金,0.0,27.9,8,5,13,3,6,3,9,3,○,19106.44,20805.45
2017/7/22,32724,○,日本ハム,多和田,166,西武ドーム,2017,7,22,土,0.0,27.9,4,0,4,4,8,5,13,3,○,19106.44,19673.16
2017/7/23,32590,○,日本ハム,その他,214,西武ドーム,2017,7,23,日,0.0,26.2,9,2,11,7,4,0,4,4,○,19106.44,21263.5
2017/7/25,14386,○,オリックス,十亀,177,西武ドーム,2017,7,25,火,42.0,27.6,7,2,9,5,9,2,11,7,○,19106.44,19019.58
2017/7/26,15304,○,オリックス,その他,171,西武ドーム,2017,7,26,水,14.5,23.9,6,2,8,4,7,2,9,5,○,19106.44,19753.74
2017/7/27,16151,○,オリックス,菊池,176,西武ドーム,2017,7,27,木,0.0,24.0,2,0,2,2,6,2,8,4,○,19106.44,21138.49
2017/8/1,17865,○,楽天,十亀,175,西武ドーム,2017,8,1,火,8.5,25.3,8,0,8,8,2,0,2,2,○,20720.23,22001.45
2017/8/2,19611,○,楽天,その他,162,西武ドーム,2017,8,2,水,0.5,21.8,7,4,11,3,8,0,8,8,○,20720.23,20570.03
2017/8/3,20355,○,楽天,菊池,180,西武ドーム,2017,8,3,木,0.0,23.4,8,1,9,7,7,4,11,3,○,20720.23,21970.81
2017/8/4,26590,○,ソフトバンク,野上,220,西武ドーム,2017,8,4,金,0.0,24.7,8,4,12,4,8,1,9,7,○,20720.23,22697.37
2017/8/5,32579,●,ソフトバンク,多和田,256,西武ドーム,2017,8,5,土,0.0,27.3,7,8,15,-1,8,4,12,4,○,20720.23,23356.53
2017/8/6,30588,○,ソフトバンク,その他,163,西武ドーム,2017,8,6,日,0.0,28.1,6,1,7,5,7,8,15,-1,●,20720.23,19710.77
2017/8/15,28772,○,楽天,その他,220,西武ドーム,2017,8,15,火,34.5,22.3,17,8,25,9,6,1,7,5,○,20720.23,21160.21
2017/8/16,26154,○,楽天,その他,160,西武ドーム,2017,8,16,水,28.0,20.8,5,0,5,5,17,8,25,9,○,20720.23,20196.04
2017/8/17,25948,○,楽天,菊池,174,西武ドーム,2017,8,17,木,1.0,23.6,3,0,3,3,5,0,5,5,○,20720.23,20806.97
2017/8/25,17436,○,オリックス,野上,159,県営大宮,2017,8,25,金,0.0,27.7,8,0,8,8,3,0,3,3,○,20720.23,19019.58
2017/8/26,31503,●,オリックス,多和田,181,西武ドーム,2017,8,26,土,0.0,26.9,0,9,9,-9,8,0,8,8,○,20720.23,19753.74
2017/8/27,25724,●,オリックス,その他,229,西武ドーム,2017,8,27,日,0.0,25.1,9,10,19,-1,0,9,9,-9,●,20720.23,21138.49
2017/9/5,13739,○,ロッテ,十亀,182,西武ドーム,2017,9,5,火,0.0,23.0,5,2,7,3,9,10,19,-1,●,20473.55,23356.53
2017/9/6,13086,●,ロッテ,その他,207,西武ドーム,2017,9,6,水,6.0,20.9,7,8,15,-1,5,2,7,3,○,20473.55,19710.77
2017/9/7,13158,○,ロッテ,菊池,145,西武ドーム,2017,9,7,木,0.5,21.5,3,0,3,3,7,8,15,-1,●,20473.55,18786.29
2017/9/8,26450,●,日本ハム,野上,168,西武ドーム,2017,9,8,金,0.0,23.5,2,9,11,-7,3,0,3,3,○,20473.55,17143.54
2017/9/9,30439,●,日本ハム,多和田,160,西武ドーム,2017,9,9,土,0.0,23.4,0,1,1,-1,2,9,11,-7,●,20473.55,18510.93
2017/9/10,30663,○,日本ハム,その他,191,西武ドーム,2017,9,10,日,0.0,24.2,8,7,15,1,0,1,1,-1,●,20473.55,17777.52
2017/9/16,30608,●,ソフトバンク,野上,199,西武ドーム,2017,9,16,土,10.5,19.0,3,7,10,-4,8,7,15,1,○,20473.55,20196.04
2017/9/17,28033,○,ソフトバンク,多和田,238,西武ドーム,2017,9,17,日,50.5,17.8,3,2,5,1,3,7,10,-4,●,20473.55,20806.97
2017/9/18,30996,○,ソフトバンク,その他,264,西武ドーム,2017,9,18,月,19.5,26.3,14,13,27,1,3,2,5,1,○,20473.55,19713.64
2017/9/19,13265,●,ロッテ,その他,183,西武ドーム,2017,9,19,火,0.0,23.2,3,6,9,-3,14,13,27,1,○,20473.55,19628.91
2017/9/20,15727,●,ロッテ,十亀,153,西武ドーム,2017,9,20,水,0.0,21.4,1,3,4,-2,3,6,9,-3,●,20473.55,20765.17
2017/9/21,18986,●,ロッテ,菊池,183,西武ドーム,2017,9,21,木,0.0,22.1,3,4,7,-1,1,3,4,-2,●,20473.55,20805.45
2017/9/23,26402,○,オリックス,野上,132,西武ドーム,2017,9,23,土,17.0,19.2,5,0,5,5,3,4,7,-1,●,20473.55,21263.5
2017/9/24,26261,○,オリックス,その他,204,西武ドーム,2017,9,24,日,0.0,21.1,8,5,13,3,5,0,5,5,○,20473.55,18457.52
2017/10/2,19631,●,楽天,十亀,206,西武ドーム,2017,10,2,月,2.0,20.3,1,2,3,-1,8,5,13,3,○,16821.42,20570.03
2017/10/3,21611,○,楽天,菊池,198,西武ドーム,2017,10,3,火,0.0,21.6,10,3,13,7,1,2,3,-1,●,16821.42,21970.81
2017/10/5,27379,●,日本ハム,その他,188,西武ドーム,2017,10,5,木,0.0,15.3,6,8,14,-2,10,3,13,7,○,16821.42,23356.53
2018/4/3,29925,○,ソフトバンク,十亀,175,西武ドーム,2018,4,3,火,0.0,16.7,7,4,11,3,6,8,14,-2,●,17693.64,21970.81
2018/4/4,19986,○,ソフトバンク,その他,171,西武ドーム,2018,4,4,水,0.0,19.0,2,1,3,1,7,4,11,3,○,17693.64,22697.37
2018/4/6,12879,○,オリックス,菊池,167,西武ドーム,2018,4,6,金,2.0,16.9,5,1,6,4,2,1,3,1,○,17693.64,19710.77
2018/4/7,27675,○,オリックス,多和田,166,西武ドーム,2018,4,7,土,0.5,14.5,6,3,9,3,5,1,6,4,○,17693.64,18786.29
2018/4/8,31666,○,オリックス,その他,183,西武ドーム,2018,4,8,日,0.0,9.7,7,4,11,3,6,3,9,3,○,17693.64,17143.54
2018/4/17,44978,●,日本ハム,十亀,230,東京ドーム,2018,4,17,火,3.5,10.9,2,7,9,-5,7,4,11,3,○,17693.64,20806.97
2018/4/18,12975,○,日本ハム,その他,227,西武ドーム,2018,4,18,水,15.0,12.3,9,8,17,1,2,7,9,-5,●,17693.64,19713.64
2018/4/20,14799,○,ロッテ,菊池,196,西武ドーム,2018,4,20,金,0.0,17.5,9,8,17,1,9,8,17,1,○,17693.64,20765.17
2018/4/21,27512,○,ロッテ,多和田,187,西武ドーム,2018,4,21,土,0.0,17.8,9,3,12,6,9,8,17,1,○,17693.64,20805.45
2018/4/22,27722,○,ロッテ,その他,189,西武ドーム,2018,4,22,日,0.0,19.7,11,5,16,6,9,3,12,6,○,17693.64,19673.16
2018/4/28,27874,○,楽天,菊池,180,西武ドーム,2018,4,28,土,0.0,18.8,7,3,10,4,11,5,16,6,○,17693.64,20998.5
2018/4/29,32741,○,楽天,多和田,196,西武ドーム,2018,4,29,日,0.0,18.7,16,4,20,12,7,3,10,4,○,17693.64,22562.68
2018/4/30,32243,○,楽天,その他,155,西武ドーム,2018,4,30,月,0.0,19.4,5,2,7,3,16,4,20,12,○,17693.64,21898.1
2018/5/8,17422,●,ソフトバンク,その他,224,県営大宮,2018,5,8,火,13.0,12.0,0,5,5,-5,5,2,7,3,○,22741.88,17143.54
2018/5/9,17381,●,ソフトバンク,十亀,151,西武ドーム,2018,5,9,水,25.5,11.4,0,3,3,-3,0,5,5,-5,●,22741.88,18510.93
2018/5/11,16419,●,ロッテ,その他,177,西武ドーム,2018,5,11,金,0.0,15.2,3,12,15,-9,0,3,3,-3,●,22741.88,21121.18
2018/5/12,32521,●,ロッテ,多和田,189,西武ドーム,2018,5,12,土,0.0,18.3,2,11,13,-9,3,12,15,-9,●,22741.88,20345.97
2018/5/13,28731,○,ロッテ,その他,158,西武ドーム,2018,5,13,日,36.0,16.0,6,0,6,6,2,11,13,-9,●,22741.88,19970.56
2018/5/25,21140,●,日本ハム,その他,211,西武ドーム,2018,5,25,金,0.0,21.0,5,8,13,-3,6,0,6,6,○,22741.88,19019.58
2018/5/26,31142,●,日本ハム,多和田,263,西武ドーム,2018,5,26,土,0.0,21.0,5,6,11,-1,5,8,13,-3,●,22741.88,19753.74
2018/5/27,32357,●,日本ハム,その他,224,西武ドーム,2018,5,27,日,0.0,20.7,8,10,18,-2,5,6,11,-1,●,22741.88,21138.49
2018/6/1,28261,○,阪神,菊池,179,西武ドーム,2018,6,1,金,0.5,20.9,2,0,2,2,8,10,18,-2,●,22359.4,22001.45
2018/6/2,32850,●,阪神,多和田,227,西武ドーム,2018,6,2,土,0.0,21.4,5,10,15,-5,2,0,2,2,○,22359.4,20570.03
2018/6/3,31571,○,阪神,その他,191,西武ドーム,2018,6,3,日,0.0,22.1,10,5,15,5,5,10,15,-5,●,22359.4,21970.81
2018/6/12,17088,●,ヤクルト,その他,165,県営大宮,2018,6,12,火,3.5,20.1,1,3,4,-2,10,5,15,5,○,22359.4,20345.97
2018/6/13,22989,○,ヤクルト,今井,211,西武ドーム,2018,6,13,水,0.0,21.1,7,4,11,3,1,3,4,-2,●,22359.4,19970.56
2018/6/14,18559,●,ヤクルト,十亀,191,西武ドーム,2018,6,14,木,0.0,20.0,4,6,10,-2,7,4,11,3,○,22359.4,20046.41
2018/6/15,21062,○,中日,菊池,216,西武ドーム,2018,6,15,金,3.5,16.5,3,2,5,1,4,6,10,-2,●,22359.4,21160.21
2018/6/16,31191,○,中日,その他,189,西武ドーム,2018,6,16,土,1.5,14.8,9,2,11,7,3,2,5,1,○,22359.4,20196.04
2018/6/17,31382,●,中日,その他,182,西武ドーム,2018,6,17,日,0.0,17.2,3,11,14,-8,9,2,11,7,○,22359.4,20806.97
2018/6/26,10654,●,オリックス,十亀,172,西武ドーム,2018,6,26,火,0.0,25.0,2,4,6,-2,3,11,14,-8,●,22359.4,19753.74
2018/6/27,17390,△,オリックス,その他,277,西武ドーム,2018,6,27,水,0.0,27.4,3,3,6,0,2,4,6,-2,●,22359.4,21138.49
2018/6/28,10697,○,オリックス,多和田,212,西武ドーム,2018,6,28,木,0.0,27.0,14,11,25,3,3,3,6,0,△,22359.4,20998.5
2018/6/29,19127,●,楽天,菊池,205,西武ドーム,2018,6,29,金,0.0,28.2,1,15,16,-14,14,11,25,3,○,22359.4,22562.68
2018/6/30,32037,●,楽天,今井,196,西武ドーム,2018,6,30,土,0.0,28.4,1,9,10,-8,1,15,16,-14,●,22359.4,21898.1
2018/7/1,30351,○,楽天,その他,234,西武ドーム,2018,7,1,日,0.0,27.4,8,7,15,1,1,9,10,-8,●,19106.44,22001.45
2018/7/9,14992,○,ロッテ,今井,211,西武ドーム,2018,7,9,月,0.0,26.7,11,5,16,6,8,7,15,1,○,19106.44,18510.93
2018/7/10,12490,●,ロッテ,十亀,180,西武ドーム,2018,7,10,火,0.0,27.5,5,7,12,-2,11,5,16,6,○,19106.44,17777.52
2018/7/11,17507,○,ロッテ,その他,211,西武ドーム,2018,7,11,水,0.0,28.1,8,4,12,4,5,7,12,-2,●,19106.44,21121.18
2018/7/20,31877,●,楽天,菊池,179,西武ドーム,2018,7,20,金,0.0,29.5,2,7,9,-5,8,4,12,4,○,19106.44,20765.17
2018/7/21,31389,●,楽天,今井,215,西武ドーム,2018,7,21,土,0.0,30.1,7,9,16,-2,2,7,9,-5,●,19106.44,20805.45
2018/7/22,31686,○,楽天,その他,176,西武ドーム,2018,7,22,日,0.0,30.8,6,3,9,3,7,9,16,-2,●,19106.44,19673.16
2018/7/24,15990,○,オリックス,多和田,163,西武ドーム,2018,7,24,火,0.0,29.9,7,1,8,6,6,3,9,3,○,19106.44,18457.52
2018/7/25,21291,○,オリックス,十亀,233,西武ドーム,2018,7,25,水,0.0,28.8,6,5,11,1,7,1,8,6,○,19106.44,19019.58
2018/7/26,18039,○,オリックス,菊池,186,西武ドーム,2018,7,26,木,0.0,26.2,2,1,3,1,6,5,11,1,○,19106.44,19753.74
2018/7/31,20602,○,ソフトバンク,多和田,162,西武ドーム,2018,7,31,火,0.0,28.3,7,4,11,3,2,1,3,1,○,19106.44,21679.45
2018/8/1,20463,●,ソフトバンク,その他,186,西武ドーム,2018,8,1,水,0.0,30.0,6,14,20,-8,7,4,11,3,○,20720.23,22001.45
2018/8/2,21357,○,ソフトバンク,今井,188,西武ドーム,2018,8,2,木,0.0,30.3,10,2,12,8,6,14,20,-8,●,20720.23,20570.03
2018/8/3,21904,○,日本ハム,菊池,203,西武ドーム,2018,8,3,金,9.5,30.1,4,3,7,1,10,2,12,8,○,20720.23,21970.81
2018/8/4,31721,●,日本ハム,その他,229,西武ドーム,2018,8,4,土,0.0,29.0,3,6,9,-3,4,3,7,1,○,20720.23,22697.37
2018/8/5,26605,○,日本ハム,その他,192,西武ドーム,2018,8,5,日,0.0,30.2,7,4,11,3,3,6,9,-3,●,20720.23,23356.53
2018/8/14,27628,○,オリックス,多和田,190,西武ドーム,2018,8,14,火,0.0,28.3,7,6,13,1,7,4,11,3,○,20720.23,20046.41
2018/8/15,23777,●,オリックス,その他,164,西武ドーム,2018,8,15,水,0.0,29.0,3,4,7,-1,7,6,13,1,○,20720.23,21160.21
2018/8/16,23985,△,オリックス,今井,250,西武ドーム,2018,8,16,木,0.0,27.4,1,1,2,0,3,4,7,-1,●,20720.23,20196.04
2018/8/17,27049,●,日本ハム,菊池,189,西武ドーム,2018,8,17,金,0.0,24.9,3,5,8,-2,1,1,2,0,△,20720.23,20806.97
2018/8/18,30966,○,日本ハム,十亀,208,西武ドーム,2018,8,18,土,0.0,21.9,7,6,13,1,3,5,8,-2,●,20720.23,19713.64
2018/8/19,26505,○,日本ハム,その他,214,西武ドーム,2018,8,19,日,0.0,22.6,7,4,11,3,7,6,13,1,○,20720.23,19628.91
2018/8/28,15512,○,楽天,多和田,194,前橋,2018,8,28,火,0.5,25.2,6,5,11,1,7,4,11,3,○,20720.23,20998.5
2018/8/29,17323,○,楽天,その他,198,県営大宮,2018,8,29,水,0.0,25.3,5,4,9,1,6,5,11,1,○,20720.23,22562.68
2018/9/7,25612,○,ロッテ,菊池,220,西武ドーム,2018,9,7,金,0.0,25.6,10,4,14,6,5,4,9,1,○,20473.55,18786.29
2018/9/8,30031,●,ロッテ,十亀,257,西武ドーム,2018,9,8,土,2.5,26.9,9,13,22,-4,10,4,14,6,○,20473.55,17143.54
2018/9/9,29940,○,ロッテ,今井,203,西武ドーム,2018,9,9,日,1.5,25.7,6,2,8,4,9,13,22,-4,●,20473.55,18510.93
2018/9/14,24480,○,楽天,菊池,154,西武ドーム,2018,9,14,金,8.0,20.7,10,5,15,5,6,2,8,4,○,20473.55,20046.41
2018/9/15,30264,○,ソフトバンク,その他,236,西武ドーム,2018,9,15,土,11.5,20.3,11,5,16,6,10,5,15,5,○,20473.55,21160.21
2018/9/16,30902,○,ソフトバンク,今井,220,西武ドーム,2018,9,16,日,0.0,22.7,8,5,13,3,11,5,16,6,○,20473.55,20196.04
2018/9/17,31646,○,ソフトバンク,その他,210,西武ドーム,2018,9,17,月,0.5,23.9,8,1,9,7,8,5,13,3,○,20473.55,20806.97
2018/9/18,25075,○,日本ハム,多和田,193,西武ドーム,2018,9,18,火,0.0,23.5,7,4,11,3,8,1,9,7,○,20473.55,19713.64
2018/9/19,25978,○,日本ハム,その他,194,西武ドーム,2018,9,19,水,0.5,21.6,12,4,16,8,7,4,11,3,○,20473.55,19628.91
2018/9/27,25672,○,ソフトバンク,その他,218,西武ドーム,2018,9,27,木,22.5,15.4,7,5,12,2,12,4,16,8,○,20473.55,21138.49
2018/9/28,26042,○,ソフトバンク,菊池,178,西武ドーム,2018,9,28,金,0.0,19.5,5,3,8,2,7,5,12,2,○,20473.55,20998.5
2018/9/29,31577,●,ソフトバンク,今井,198,西武ドーム,2018,9,29,土,11.0,17.5,1,3,4,-2,5,3,8,2,○,20473.55,22562.68
2019/4/2,27102,○,ロッテ,その他,218,西武ドーム,2019,4,2,火,0.0,6.0,7,4,11,3,1,3,4,-2,●,17693.64,20570.03
2019/4/3,24902,○,ロッテ,その他,183,西武ドーム,2019,4,3,水,0.0,6.5,9,3,12,6,7,4,11,3,○,17693.64,21970.81
2019/4/4,24480,○,ロッテ,その他,180,西武ドーム,2019,4,4,木,0.0,9.0,8,6,14,2,9,3,12,6,○,17693.64,22697.37
2019/4/9,16355,●,楽天,その他,225,県営大宮,2019,4,9,火,0.0,9.1,6,7,13,-1,8,6,14,2,○,17693.64,18510.93
2019/4/10,12956,●,楽天,その他,206,西武ドーム,2019,4,10,水,24.5,3.5,5,7,12,-2,6,7,13,-1,●,17693.64,17777.52
2019/4/12,11914,○,オリックス,多和田,181,西武ドーム,2019,4,12,金,0.0,8.3,1,0,1,1,5,7,12,-2,●,17693.64,20345.97
2019/4/13,24230,●,オリックス,今井,194,西武ドーム,2019,4,13,土,0.0,10.8,3,10,13,-7,1,0,1,1,○,17693.64,19970.56
2019/4/14,30893,○,オリックス,その他,192,西武ドーム,2019,4,14,日,0.0,13.0,11,3,14,8,3,10,13,-7,●,17693.64,20046.41
2019/4/19,18483,●,ソフトバンク,多和田,205,西武ドーム,2019,4,19,金,0.0,16.7,0,2,2,-2,11,3,14,8,○,17693.64,19628.91
2019/4/20,27561,○,ソフトバンク,今井,221,西武ドーム,2019,4,20,土,0.0,13.7,6,4,10,2,0,2,2,-2,●,17693.64,20765.17
2019/4/21,28274,●,ソフトバンク,その他,222,西武ドーム,2019,4,21,日,0.0,15.9,5,16,21,-11,6,4,10,2,○,17693.64,20805.45
2019/5/1,30650,●,日本ハム,その他,213,西武ドーム,2019,5,1,水,14.0,17.0,2,7,9,-5,5,16,21,-11,●,22741.88,22001.45
2019/5/2,31336,○,日本ハム,その他,163,西武ドーム,2019,5,2,木,0.5,17.2,5,3,8,2,2,7,9,-5,●,22741.88,20570.03
2019/5/3,30474,●,日本ハム,その他,194,西武ドーム,2019,5,3,金,0.0,17.1,3,10,13,-7,5,3,8,2,○,22741.88,21970.81
2019/5/4,30232,○,楽天,多和田,265,西武ドーム,2019,5,4,土,9.5,16.2,7,6,13,1,3,10,13,-7,●,22741.88,22697.37
2019/5/5,30278,○,楽天,今井,147,西武ドーム,2019,5,5,日,0.0,17.1,4,0,4,4,7,6,13,1,○,22741.88,23356.53
2019/5/6,28885,●,楽天,その他,214,西武ドーム,2019,5,6,月,0.0,17.2,4,8,12,-4,4,0,4,4,○,22741.88,19710.77
2019/5/8,14507,●,ロッテ,その他,198,前橋,2019,5,8,水,0.0,15.0,1,12,13,-11,4,8,12,-4,●,22741.88,17143.54
2019/5/9,17235,●,ロッテ,その他,250,県営大宮,2019,5,9,木,0.0,16.3,4,5,9,-1,1,12,13,-11,●,22741.88,18510.93
2019/5/21,16745,○,ソフトバンク,十亀,242,那覇,2019,5,21,火,96.5,18.4,7,6,13,1,4,5,9,-1,●,22741.88,20805.45
2019/5/22,17872,○,ソフトバンク,その他,220,那覇,2019,5,22,水,0.0,18.3,7,3,10,4,7,6,13,1,○,22741.88,19673.16
2019/5/24,26704,○,日本ハム,その他,197,西武ドーム,2019,5,24,金,0.0,21.4,10,5,15,5,7,3,10,4,○,22741.88,18457.52
2019/5/25,30814,○,日本ハム,多和田,198,西武ドーム,2019,5,25,土,0.0,23.0,7,5,12,2,10,5,15,5,○,22741.88,19019.58
2019/5/26,28451,●,日本ハム,その他,232,西武ドーム,2019,5,26,日,0.0,23.9,5,6,11,-1,7,5,12,2,○,22741.88,19753.74
2019/6/4,25934,○,広島,今井,264,西武ドーム,2019,6,4,火,0.0,21.5,5,4,9,1,5,6,11,-1,●,22359.4,22697.37
2019/6/5,26831,●,広島,十亀,203,西武ドーム,2019,6,5,水,0.0,21.4,1,9,10,-8,5,4,9,1,○,22359.4,23356.53
2019/6/6,26163,○,広島,その他,179,西武ドーム,2019,6,6,木,0.0,24.9,9,2,11,7,1,9,10,-8,●,22359.4,19710.77
2019/6/11,26552,○,巨人,その他,158,西武ドーム,2019,6,11,火,5.0,17.9,4,0,4,4,9,2,11,7,○,22359.4,21121.18
2019/6/12,27066,●,巨人,十亀,194,西武ドーム,2019,6,12,水,1.5,17.6,4,9,13,-5,4,0,4,4,○,22359.4,20345.97
2019/6/13,26037,●,巨人,その他,185,西武ドーム,2019,6,13,木,0.0,19.9,2,8,10,-6,4,9,13,-5,●,22359.4,19970.56
2019/6/14,25940,○,ヤクルト,その他,167,西武ドーム,2019,6,14,金,0.0,21.1,11,1,12,10,2,8,10,-6,●,22359.4,20046.41
2019/6/15,30264,●,ヤクルト,その他,188,西武ドーム,2019,6,15,土,56.5,16.3,5,6,11,-1,11,1,12,10,○,22359.4,21160.21
2019/6/16,30654,○,ヤクルト,その他,204,西武ドーム,2019,6,16,日,8.0,22.2,10,6,16,4,5,6,11,-1,●,22359.4,20196.04
2019/6/28,18957,●,オリックス,今井,166,西武ドーム,2019,6,28,金,32.0,24.5,0,4,4,-4,10,6,16,4,○,22359.4,20998.5
2019/6/29,28811,○,オリックス,その他,189,西武ドーム,2019,6,29,土,11.5,19.5,7,0,7,7,0,4,4,-4,●,22359.4,22562.68
2019/6/30,31187,○,オリックス,その他,236,西武ドーム,2019,6,30,日,4.5,21.3,11,3,14,8,7,0,7,7,○,22359.4,21898.1
2019/7/15,29640,●,ロッテ,今井,209,西武ドーム,2019,7,15,月,18.0,20.4,5,6,11,-1,11,3,14,8,○,19106.44,21160.21
2019/7/16,18783,○,ロッテ,十亀,188,西武ドーム,2019,7,16,火,28.5,20.1,5,1,6,4,5,6,11,-1,●,19106.44,20196.04
2019/7/17,20519,○,ロッテ,その他,174,西武ドーム,2019,7,17,水,0.0,23.5,4,3,7,1,5,1,6,4,○,19106.44,20806.97
2019/7/19,26912,○,オリックス,その他,239,西武ドーム,2019,7,19,金,3.5,25.4,5,4,9,1,4,3,7,1,○,19106.44,19628.91
2019/7/20,30200,●,オリックス,多和田,173,西武ドーム,2019,7,20,土,0.0,25.7,1,3,4,-2,5,4,9,1,○,19106.44,20765.17
2019/7/21,30097,○,オリックス,その他,179,西武ドーム,2019,7,21,日,1.0,24.4,10,3,13,7,1,3,4,-2,●,19106.44,20805.45
2019/7/26,25718,●,日本ハム,十亀,239,西武ドーム,2019,7,26,金,13.0,26.8,7,12,19,-5,10,3,13,7,○,19106.44,19753.74
2019/7/27,30668,●,日本ハム,多和田,257,西武ドーム,2019,7,27,土,21.0,27.5,6,10,16,-4,7,12,19,-5,●,19106.44,21138.49
2019/7/28,30325,○,日本ハム,その他,250,西武ドーム,2019,7,28,日,14.5,27.6,8,7,15,1,6,10,16,-4,●,19106.44,20998.5
2019/7/30,23972,○,ソフトバンク,今井,214,西武ドーム,2019,7,30,火,0.0,29.0,5,2,7,3,8,7,15,1,○,19106.44,21898.1
2019/7/31,25795,○,ソフトバンク,その他,206,西武ドーム,2019,7,31,水,0.0,29.9,2,0,2,2,5,2,7,3,○,19106.44,21679.45
2019/8/1,22681,●,ソフトバンク,その他,253,西武ドーム,2019,8,1,木,12.0,29.1,10,11,21,-1,2,0,2,2,○,20720.23,22001.45
2019/8/6,27017,●,楽天,今井,182,西武ドーム,2019,8,6,火,0.0,29.3,0,10,10,-10,10,11,21,-1,●,20720.23,19710.77
2019/8/7,23463,○,楽天,その他,204,西武ドーム,2019,8,7,水,0.0,29.4,4,3,7,1,0,10,10,-10,●,20720.23,18786.29
2019/8/8,17910,●,楽天,その他,302,県営大宮,2019,8,8,木,0.0,29.3,7,11,18,-4,4,3,7,1,○,20720.23,17143.54
2019/8/13,24748,○,オリックス,その他,209,西武ドーム,2019,8,13,火,0.0,28.0,11,4,15,7,7,11,18,-4,●,20720.23,19970.56
2019/8/14,23466,○,オリックス,その他,191,西武ドーム,2019,8,14,水,16.0,27.6,8,7,15,1,11,4,15,7,○,20720.23,20046.41
2019/8/15,23833,●,オリックス,その他,233,西武ドーム,2019,8,15,木,9.5,27.5,8,20,28,-12,8,7,15,1,○,20720.23,21160.21
2019/8/20,19138,○,日本ハム,その他,188,西武ドーム,2019,8,20,火,27.0,24.9,4,2,6,2,8,20,28,-12,●,20720.23,20765.17
2019/8/21,17694,○,日本ハム,その他,208,西武ドーム,2019,8,21,水,1.0,25.7,11,6,17,5,4,2,6,2,○,20720.23,20805.45
2019/8/22,16810,●,日本ハム,その他,209,西武ドーム,2019,8,22,木,0.5,24.7,3,5,8,-2,11,6,17,5,○,20720.23,19673.16
2019/8/23,22767,○,楽天,今井,216,西武ドーム,2019,8,23,金,5.0,25.0,8,6,14,2,3,5,8,-2,●,20720.23,21263.5
2019/8/24,25869,○,楽天,その他,258,西武ドーム,2019,8,24,土,0.5,26.4,6,5,11,1,8,6,14,2,○,20720.23,18457.52
2019/8/25,29497,●,楽天,十亀,199,西武ドーム,2019,8,25,日,3.5,25.1,2,14,16,-12,6,5,11,1,○,20720.23,19019.58
2019/8/30,24460,○,ソフトバンク,今井,189,西武ドーム,2019,8,30,金,11.5,24.4,4,2,6,2,2,14,16,-12,●,20720.23,21898.1
2019/8/31,30531,○,ソフトバンク,その他,217,西武ドーム,2019,8,31,土,0.0,26.2,10,5,15,5,4,2,6,2,○,20720.23,21679.45
2019/9/1,29217,●,ソフトバンク,十亀,200,西武ドーム,2019,9,1,日,0.0,26.6,1,4,5,-3,10,5,15,5,○,20473.55,22001.45
2019/9/11,28574,○,ソフトバンク,その他,173,西武ドーム,2019,9,11,水,17.5,26.3,4,1,5,3,1,4,5,-3,●,20473.55,21121.18
2019/9/12,24660,●,ソフトバンク,十亀,205,西武ドーム,2019,9,12,木,0.0,24.5,2,3,5,-1,4,1,5,3,○,20473.55,20345.97
2019/9/13,23314,○,ロッテ,その他,178,西武ドーム,2019,9,13,金,0.0,21.1,6,1,7,5,2,3,5,-1,●,20473.55,19970.56
2019/9/14,31024,○,ロッテ,今井,220,西武ドーム,2019,9,14,土,0.0,20.5,4,3,7,1,6,1,7,5,○,20473.55,20046.41
2019/9/15,30038,○,ロッテ,その他,270,西武ドーム,2019,9,15,日,0.0,24.5,6,5,11,1,4,3,7,1,○,20473.55,21160.21
2019/9/16,29676,●,ロッテ,その他,211,西武ドーム,2019,9,16,月,16.0,23.3,3,9,12,-6,6,5,11,1,○,20473.55,20196.04
2019/9/18,24674,○,オリックス,その他,155,西武ドーム,2019,9,18,水,6.0,20.8,5,0,5,5,3,9,12,-6,●,20473.55,19713.64
2019/9/19,24118,○,日本ハム,十亀,163,西武ドーム,2019,9,19,木,0.0,21.3,2,0,2,2,5,0,5,5,○,20473.55,19628.91
2019/9/20,27982,○,楽天,その他,197,西武ドーム,2019,9,20,金,0.0,21.9,5,3,8,2,2,0,2,2,○,20473.55,20765.17
2020/7/21,4811,○,ロッテ,今井,184,西武ドーム,2020,7,21,火,2.5,24.2,8,3,11,5,5,3,8,2,○,19106.44,20805.45
2020/7/22,4806,●,ロッテ,その他,195,西武ドーム,2020,7,22,水,43.5,25.7,1,2,3,-1,8,3,11,5,○,19106.44,19673.16
2020/7/23,4812,○,ロッテ,その他,170,西武ドーム,2020,7,23,木,35.0,22.0,3,2,5,1,1,2,3,-1,●,19106.44,21263.5
2020/7/24,4825,○,ロッテ,その他,150,西武ドーム,2020,7,24,金,1.5,23.5,3,2,5,1,3,2,5,1,○,19106.44,18457.52
2020/7/25,4811,●,ロッテ,その他,179,西武ドーム,2020,7,25,土,53.5,23.2,0,5,5,-5,3,2,5,1,○,19106.44,19019.58
2020/7/26,4816,○,ロッテ,その他,181,西武ドーム,2020,7,26,日,27.0,23.5,4,2,6,2,0,5,5,-5,●,19106.44,19753.74
2020/8/11,4715,●,楽天,その他,199,西武ドーム,2020,8,11,火,0.0,31.2,5,7,12,-2,4,2,6,2,○,20720.23,21121.18
2020/8/12,4670,●,楽天,その他,197,西武ドーム,2020,8,12,水,4.0,28.3,2,6,8,-4,5,7,12,-2,●,20720.23,20345.97
2020/8/13,4718,●,楽天,その他,225,西武ドーム,2020,8,13,木,0.5,28.7,4,7,11,-3,2,6,8,-4,●,20720.23,19970.56
2020/8/14,4681,○,楽天,その他,226,西武ドーム,2020,8,14,金,0.0,28.7,13,8,21,5,4,7,11,-3,●,20720.23,20046.41
2020/8/15,4677,△,楽天,その他,193,西武ドーム,2020,8,15,土,0.0,30.2,3,3,6,0,13,8,21,5,○,20720.23,21160.21
2020/8/16,4659,○,楽天,その他,216,西武ドーム,2020,8,16,日,0.0,30.6,11,1,12,10,3,3,6,0,△,20720.23,20196.04
2020/8/25,4635,●,日本ハム,その他,230,西武ドーム,2020,8,25,火,0.0,27.3,3,4,7,-1,11,1,12,10,○,20720.23,19019.58
2020/8/26,4604,●,日本ハム,その他,215,西武ドーム,2020,8,26,水,3.0,28.4,5,8,13,-3,3,4,7,-1,●,20720.23,19753.74
2020/8/27,4591,○,日本ハム,その他,230,西武ドーム,2020,8,27,木,2.5,28.4,8,7,15,1,5,8,13,-3,●,20720.23,21138.49
2020/9/8,4721,○,オリックス,その他,143,西武ドーム,2020,9,8,火,0.0,27.7,2,0,2,2,8,7,15,1,○,20473.55,17143.54
2020/9/9,4747,○,オリックス,その他,189,西武ドーム,2020,9,9,水,0.5,27.3,13,5,18,8,2,0,2,2,○,20473.55,18510.93
2020/9/10,4675,●,オリックス,その他,212,西武ドーム,2020,9,10,木,0.0,26.1,4,12,16,-8,13,5,18,8,○,20473.55,17777.52
2020/9/15,4604,○,ロッテ,その他,158,西武ドーム,2020,9,15,火,0.0,23.0,4,3,7,1,4,12,16,-8,●,20473.55,21160.21
2020/9/16,4615,○,ロッテ,その他,180,西武ドーム,2020,9,16,水,2.5,22.6,3,1,4,2,4,3,7,1,○,20473.55,20196.04
2020/9/17,4621,●,ロッテ,その他,179,西武ドーム,2020,9,17,木,0.0,23.9,1,8,9,-7,3,1,4,2,○,20473.55,20806.97
2020/9/22,9471,●,日本ハム,その他,199,西武ドーム,2020,9,22,火,0.5,21.4,1,5,6,-4,1,8,9,-7,●,20473.55,19673.16
2020/9/23,6612,○,日本ハム,その他,215,西武ドーム,2020,9,23,水,8.5,19.0,6,5,11,1,1,5,6,-4,●,20473.55,21263.5
2020/9/24,6438,●,日本ハム,その他,213,西武ドーム,2020,9,24,木,5.0,18.1,2,12,14,-10,6,5,11,1,○,20473.55,18457.52
2020/9/25,7691,○,楽天,その他,197,西武ドーム,2020,9,25,金,14.5,18.7,5,4,9,1,2,12,14,-10,●,20473.55,19019.58
2020/9/26,9401,○,楽天,その他,212,西武ドーム,2020,9,26,土,8.0,17.5,5,1,6,4,5,4,9,1,○,20473.55,19753.74
2020/9/27,9412,○,楽天,その他,196,西武ドーム,2020,9,27,日,6.5,18.6,6,2,8,4,5,1,6,4,○,20473.55,21138.49
2020/10/6,6336,○,ソフトバンク,その他,230,西武ドーム,2020,10,6,火,0.0,19.0,3,1,4,2,6,2,8,4,○,16821.42,19710.77
2020/10/7,6414,○,ソフトバンク,その他,234,西武ドーム,2020,10,7,水,7.5,17.2,4,3,7,1,3,1,4,2,○,16821.42,18786.29
2020/10/8,6597,△,ソフトバンク,今井,219,西武ドーム,2020,10,8,木,51.5,13.8,4,4,8,0,4,3,7,1,○,16821.42,17143.54
2020/10/16,8440,○,オリックス,今井,205,西武ドーム,2020,10,16,金,0.0,14.5,2,1,3,1,4,4,8,0,△,16821.42,20196.04
2020/10/17,11169,●,オリックス,十亀,183,西武ドーム,2020,10,17,土,17.5,11.6,1,4,5,-3,2,1,3,1,○,16821.42,20806.97
2020/10/18,11117,○,オリックス,その他,149,西武ドーム,2020,10,18,日,0.0,13.2,3,2,5,1,1,4,5,-3,●,16821.42,19713.64
2020/10/20,7668,○,ロッテ,その他,174,西武ドーム,2020,10,20,火,0.0,13.6,2,1,3,1,3,2,5,1,○,16821.42,20765.17
2020/10/21,8147,○,ロッテ,その他,191,西武ドーム,2020,10,21,水,0.0,14.5,2,1,3,1,2,1,3,1,○,16821.42,20805.45
2020/10/22,8264,○,ロッテ,その他,202,西武ドーム,2020,10,22,木,0.0,15.6,7,4,11,3,2,1,3,1,○,16821.42,19673.16
2020/10/27,4480,○,楽天,その他,184,西武ドーム,2020,10,27,火,0.0,14.3,4,3,7,1,7,4,11,3,○,16821.42,21138.49
2020/10/28,4776,○,楽天,その他,187,西武ドーム,2020,10,28,水,0.0,14.9,4,3,7,1,4,3,7,1,○,16821.42,20998.5
2020/10/29,5645,●,楽天,その他,233,西武ドーム,2020,10,29,木,0.0,15.1,5,13,18,-8,4,3,7,1,○,16821.42,22562.68
2020/10/30,7789,●,ソフトバンク,その他,197,西武ドーム,2020,10,30,金,0.0,13.2,3,4,7,-1,5,13,18,-8,●,16821.42,21898.1
2020/10/31,11276,●,ソフトバンク,十亀,182,西武ドーム,2020,10,31,土,0.0,11.0,2,11,13,-9,3,4,7,-1,●,16821.42,21679.45
2020/11/1,11331,○,ソフトバンク,その他,175,西武ドーム,2020,11,1,日,0.0,12.5,3,1,4,2,2,11,13,-9,●,11040.75,22001.45
2020/11/2,10139,○,日本ハム,その他,181,西武ドーム,2020,11,2,月,0.5,13.5,4,0,4,4,3,1,4,2,○,11040.75,20570.03
2020/11/3,11392,○,日本ハム,その他,212,西武ドーム,2020,11,3,火,4.0,14.2,5,4,9,1,4,0,4,4,○,11040.75,21970.81
2020/11/4,11301,○,日本ハム,その他,182,西武ドーム,2020,11,4,水,0.0,12.0,10,3,13,7,5,4,9,1,○,11040.75,22697.37
2021/3/26,9599,○,オリックス,その他,150,西武ドーム,2021,3,26,金,0.0,12.3,4,3,7,1,10,3,13,7,○,23307.61,19753.74
2021/3/27,9525,●,オリックス,その他,184,西武ドーム,2021,3,27,土,0.0,11.6,2,3,5,-1,4,3,7,1,○,23307.61,21138.49
2021/3/28,9517,○,オリックス,その他,171,西武ドーム,2021,3,28,日,0.0,14.4,5,1,6,4,2,3,5,-1,●,23307.61,20998.5
2021/4/6,8608,●,楽天,その他,192,西武ドーム,2021,4,6,火,0.0,9.3,2,13,15,-11,5,1,6,4,○,17693.64,19710.77
2021/4/7,7390,●,楽天,今井,219,西武ドーム,2021,4,7,水,0.0,12.0,3,6,9,-3,2,13,15,-11,●,17693.64,18786.29
2021/4/8,6653,●,楽天,その他,163,西武ドーム,2021,4,8,木,0.0,12.6,0,4,4,-4,3,6,9,-3,●,17693.64,17143.54
2021/4/13,5900,●,日本ハム,その他,204,西武ドーム,2021,4,13,火,0.0,14.0,2,3,5,-1,0,4,4,-4,●,17693.64,19970.56
2021/4/14,6079,○,日本ハム,今井,200,西武ドーム,2021,4,14,水,16.0,13.8,2,1,3,1,2,3,5,-1,●,17693.64,20046.41
2021/4/16,9238,○,ソフトバンク,その他,153,西武ドーム,2021,4,16,金,0.0,12.4,2,1,3,1,2,1,3,1,○,17693.64,20196.04
2021/4/17,9461,●,ソフトバンク,その他,179,西武ドーム,2021,4,17,土,39.0,13.3,1,7,8,-6,2,1,3,1,○,17693.64,20806.97
2021/4/18,9468,△,ソフトバンク,その他,187,西武ドーム,2021,4,18,日,4.5,14.3,4,4,8,0,1,7,8,-6,●,17693.64,19713.64
2021/4/27,9272,○,ロッテ,その他,149,西武ドーム,2021,4,27,火,0.0,12.5,3,1,4,2,4,4,8,0,△,17693.64,21138.49
2021/4/28,7829,○,ロッテ,今井,185,西武ドーム,2021,4,28,水,0.0,16.7,3,2,5,1,3,1,4,2,○,17693.64,20998.5
2021/4/29,12850,●,ロッテ,その他,180,西武ドーム,2021,4,29,木,17.5,15.7,2,5,7,-3,3,2,5,1,○,17693.64,22562.68
2021/5/3,13195,●,オリックス,その他,195,西武ドーム,2021,5,3,月,0.0,14.6,3,6,9,-3,2,5,7,-3,●,22741.88,21970.81
2021/5/4,11592,△,オリックス,その他,238,西武ドーム,2021,5,4,火,0.0,16.4,6,6,12,0,3,6,9,-3,●,22741.88,22697.37
2021/5/5,9616,○,オリックス,今井,184,西武ドーム,2021,5,5,水,0.0,17.2,6,2,8,4,6,6,12,0,△,22741.88,23356.53
2021/5/18,9749,●,ソフトバンク,その他,169,西武ドーム,2021,5,18,火,2.0,18.8,2,8,10,-6,6,2,8,4,○,22741.88,19713.64
2021/5/19,7167,●,ソフトバンク,今井,250,西武ドーム,2021,5,19,水,8.0,16.5,5,6,11,-1,2,8,10,-6,●,22741.88,19628.91
2021/5/20,7587,○,ソフトバンク,その他,185,西武ドーム,2021,5,20,木,2.5,17.8,7,2,9,5,5,6,11,-1,●,22741.88,20765.17
2021/5/21,7657,○,日本ハム,その他,198,西武ドーム,2021,5,21,金,7.5,19.1,7,1,8,6,7,2,9,5,○,22741.88,20805.45
2021/5/22,10047,○,日本ハム,その他,189,西武ドーム,2021,5,22,土,6.5,18.1,8,1,9,7,7,1,8,6,○,22741.88,19673.16
2021/5/23,9127,●,日本ハム,その他,204,西武ドーム,2021,5,23,日,0.0,18.3,3,10,13,-7,8,1,9,7,○,22741.88,21263.5
2021/5/28,4751,●,阪神,その他,230,西武ドーム,2021,5,28,金,0.0,19.3,7,10,17,-3,3,10,13,-7,●,22741.88,20998.5
2021/5/29,4810,○,阪神,今井,195,西武ドーム,2021,5,29,土,0.0,21.4,1,0,1,1,7,10,17,-3,●,22741.88,22562.68
2021/5/30,4763,●,阪神,その他,235,西武ドーム,2021,5,30,日,7.0,20.2,8,9,17,-1,1,0,1,1,○,22741.88,21898.1
2021/6/8,7780,○,DeNA,その他,194,西武ドーム,2021,6,8,火,0.0,22.7,8,3,11,5,8,9,17,-1,●,22359.4,17143.54
2021/6/9,7930,△,DeNA,その他,207,西武ドーム,2021,6,9,水,0.0,23.4,8,8,16,0,8,3,11,5,○,22359.4,18510.93
2021/6/10,7459,○,DeNA,その他,194,西武ドーム,2021,6,10,木,0.0,23.0,5,3,8,2,8,8,16,0,△,22359.4,17777.52
2021/6/11,9683,●,中日,その他,209,西武ドーム,2021,6,11,金,0.0,22.7,5,6,11,-1,5,3,8,2,○,22359.4,21121.18
2021/6/12,13125,○,中日,今井,190,西武ドーム,2021,6,12,土,0.0,22.0,7,3,10,4,5,6,11,-1,●,22359.4,20345.97
2021/6/13,13060,○,中日,その他,160,西武ドーム,2021,6,13,日,0.5,22.7,4,3,7,1,7,3,10,4,○,22359.4,19970.56
2021/6/18,4857,●,ロッテ,その他,201,西武ドーム,2021,6,18,金,0.0,21.6,0,5,5,-5,4,3,7,1,○,22359.4,19713.64
2021/6/19,7597,○,ロッテ,今井,172,西武ドーム,2021,6,19,土,10.0,19.6,7,2,9,5,0,5,5,-5,●,22359.4,19628.91
2021/6/20,7726,△,ロッテ,その他,193,西武ドーム,2021,6,20,日,6.0,22.3,3,3,6,0,7,2,9,5,○,22359.4,20765.17
2021/6/22,8420,○,楽天,その他,169,西武ドーム,2021,6,22,火,0.0,22.5,2,0,2,2,3,3,6,0,△,22359.4,19673.16
2021/6/23,10292,●,楽天,その他,223,西武ドーム,2021,6,23,水,34.5,20.5,4,6,10,-2,2,0,2,2,○,22359.4,21263.5
2021/7/2,10068,●,オリックス,その他,205,西武ドーム,2021,7,2,金,56.0,20.2,3,5,8,-2,4,6,10,-2,●,19106.44,20570.03
2021/7/3,13119,●,オリックス,今井,153,西武ドーム,2021,7,3,土,24.5,21.8,0,8,8,-8,3,5,8,-2,●,19106.44,21970.81
2021/7/4,13231,●,オリックス,その他,158,西武ドーム,2021,7,4,日,18.5,19.5,2,3,5,-1,0,8,8,-8,●,19106.44,22697.37
2021/7/13,13399,●,ロッテ,その他,203,西武ドーム,2021,7,13,火,0.5,24.3,6,7,13,-1,2,3,5,-1,●,19106.44,19970.56
2021/7/14,9893,○,ロッテ,その他,152,西武ドーム,2021,7,14,水,4.5,24.2,8,3,11,5,6,7,13,-1,●,19106.44,20046.41
2021/8/13,7477,●,楽天,その他,204,西武ドーム,2021,8,13,金,32.0,20.9,0,5,5,-5,8,3,11,5,○,20720.23,19970.56
2021/8/14,7340,●,楽天,今井,205,西武ドーム,2021,8,14,土,28.0,20.4,6,7,13,-1,0,5,5,-5,●,20720.23,20046.41
2021/8/15,7291,○,楽天,その他,178,西武ドーム,2021,8,15,日,44.5,18.9,10,2,12,8,6,7,13,-1,●,20720.23,21160.21
2021/8/24,8899,△,ソフトバンク,その他,229,西武ドーム,2021,8,24,火,0.5,26.4,4,4,8,0,10,2,12,8,○,20720.23,18457.52
2021/8/25,8485,●,ソフトバンク,その他,196,西武ドーム,2021,8,25,水,0.0,27.5,1,6,7,-5,4,4,8,0,△,20720.23,19019.58
2021/8/26,8621,○,ソフトバンク,その他,202,西武ドーム,2021,8,26,木,0.0,29.6,3,0,3,3,1,6,7,-5,●,20720.23,19753.74
2021/8/27,8509,●,日本ハム,その他,232,西武ドーム,2021,8,27,金,0.0,29.3,2,7,9,-5,3,0,3,3,○,20720.23,21138.49
2021/8/28,9019,△,日本ハム,今井,221,西武ドーム,2021,8,28,土,0.0,28.9,8,8,16,0,2,7,9,-5,●,20720.23,20998.5
2021/8/29,9039,●,日本ハム,その他,184,西武ドーム,2021,8,29,日,0.0,27.1,0,6,6,-6,8,8,16,0,△,20720.23,22562.68
2021/9/7,5030,○,ソフトバンク,その他,194,西武ドーム,2021,9,7,火,0.0,19.5,6,5,11,1,0,6,6,-6,●,20473.55,18786.29
2021/9/8,4353,●,ソフトバンク,その他,168,西武ドーム,2021,9,8,水,0.0,19.3,0,9,9,-9,6,5,11,1,○,20473.55,17143.54
2021/9/10,4512,●,オリックス,その他,180,西武ドーム,2021,9,10,金,0.0,24.0,1,7,8,-6,0,9,9,-9,●,20473.55,17777.52
2021/9/11,7740,○,オリックス,今井,172,西武ドーム,2021,9,11,土,0.5,23.3,7,0,7,7,1,7,8,-6,●,20473.55,21121.18
2021/9/12,7261,○,オリックス,その他,167,西武ドーム,2021,9,12,日,0.0,23.1,3,1,4,2,7,0,7,7,○,20473.55,20345.97
2021/9/14,8667,○,日本ハム,その他,170,西武ドーム,2021,9,14,火,4.0,21.7,3,1,4,2,3,1,4,2,○,20473.55,20046.41
2021/9/15,8806,△,日本ハム,その他,198,西武ドーム,2021,9,15,水,3.5,22.4,3,3,6,0,3,1,4,2,○,20473.55,21160.21
2021/9/16,8553,●,日本ハム,その他,182,西武ドーム,2021,9,16,木,0.0,21.5,1,3,4,-2,3,3,6,0,△,20473.55,20196.04
2021/9/22,8756,●,楽天,その他,211,西武ドーム,2021,9,22,水,1.0,24.1,2,4,6,-2,1,3,4,-2,●,20473.55,19673.16
2021/9/23,9396,○,楽天,その他,197,西武ドーム,2021,9,23,木,0.0,24.9,4,3,7,1,2,4,6,-2,●,20473.55,21263.5
2021/9/24,8957,○,ロッテ,今井,219,西武ドーム,2021,9,24,金,0.0,23.5,5,4,9,1,4,3,7,1,○,20473.55,18457.52
2021/9/25,9221,●,ロッテ,その他,176,西武ドーム,2021,9,25,土,0.0,20.6,1,3,4,-2,5,4,9,1,○,20473.55,19019.58
2021/9/26,9234,●,ロッテ,その他,192,西武ドーム,2021,9,26,日,0.0,18.3,4,8,12,-4,1,3,4,-2,●,20473.55,19753.74
2021/10/7,8709,○,ソフトバンク,その他,192,西武ドーム,2021,10,7,木,0.0,19.1,7,0,7,7,4,8,12,-4,●,16821.42,18786.29
2021/10/8,9099,○,ソフトバンク,今井,192,西武ドーム,2021,10,8,金,0.0,22.8,6,2,8,4,7,0,7,7,○,16821.42,17143.54
2021/10/9,9301,●,楽天,その他,201,西武ドーム,2021,10,9,土,0.0,21.2,1,2,3,-1,6,2,8,4,○,16821.42,18510.93
2021/10/10,9435,○,楽天,その他,200,西武ドーム,2021,10,10,日,0.0,21.1,3,2,5,1,1,2,3,-1,●,16821.42,17777.52
2021/10/18,9106,●,ロッテ,その他,185,西武ドーム,2021,10,18,月,0.0,11.9,1,2,3,-1,3,2,5,1,○,16821.42,19713.64
2021/10/19,9523,●,日本ハム,その他,216,西武ドーム,2021,10,19,火,2.5,12.6,2,6,8,-4,1,2,3,-1,●,16821.42,19628.91
2021/10/20,10918,○,日本ハム,その他,177,西武ドーム,2021,10,20,水,0.0,15.0,7,5,12,2,2,6,8,-4,●,16821.42,20765.17
2022/3/25,22646,●,オリックス,その他,168,西武ドーム,2022,3,25,金,0.0,10.6,0,6,6,-6,7,5,12,2,○,23307.61,19019.58
2022/3/26,18109,○,オリックス,その他,157,西武ドーム,2022,3,26,土,0.5,13.8,5,0,5,5,0,6,6,-6,●,23307.61,19753.74
2022/3/27,15655,○,オリックス,その他,195,西武ドーム,2022,3,27,日,0.0,14.9,7,6,13,1,5,0,5,5,○,23307.61,21138.49
2022/4/8,9502,●,ソフトバンク,その他,181,西武ドーム,2022,4,8,金,0.0,13.9,1,8,9,-7,7,6,13,1,○,17693.64,17143.54
2022/4/9,15666,△,ソフトバンク,その他,242,西武ドーム,2022,4,9,土,0.0,15.7,0,0,0,0,1,8,9,-7,●,17693.64,18510.93
2022/4/10,21115,○,ソフトバンク,その他,197,西武ドーム,2022,4,10,日,0.0,18.0,6,0,6,6,0,0,0,0,△,17693.64,17777.52
2022/4/12,10349,●,日本ハム,その他,177,西武ドーム,2022,4,12,火,0.0,18.3,0,3,3,-3,6,0,6,6,○,17693.64,20345.97
2022/4/13,10179,○,日本ハム,その他,152,西武ドーム,2022,4,13,水,0.0,19.8,4,3,7,1,0,3,3,-3,●,17693.64,19970.56
2022/4/19,7241,○,ロッテ,その他,155,西武ドーム,2022,4,19,火,1.0,13.8,4,0,4,4,4,3,7,1,○,17693.64,19628.91
2022/4/20,7261,○,ロッテ,その他,171,西武ドーム,2022,4,20,水,2.0,11.1,3,0,3,3,4,0,4,4,○,17693.64,20765.17
2022/4/22,10224,○,楽天,その他,159,西武ドーム,2022,4,22,金,19.5,18.4,3,0,3,3,3,0,3,3,○,17693.64,19673.16
2022/4/23,26257,●,楽天,その他,194,西武ドーム,2022,4,23,土,0.0,20.4,3,7,10,-4,3,0,3,3,○,17693.64,21263.5
2022/4/24,14901,○,楽天,その他,204,西武ドーム,2022,4,24,日,2.0,16.3,6,3,9,3,3,7,10,-4,●,17693.64,18457.52
2022/5/3,21592,○,ロッテ,その他,178,西武ドーム,2022,5,3,火,0.0,13.6,4,2,6,2,6,3,9,3,○,22741.88,21970.81
2022/5/4,19827,●,ロッテ,その他,199,西武ドーム,2022,5,4,水,0.0,16.1,5,7,12,-2,4,2,6,2,○,22741.88,22697.37
2022/5/5,23646,○,ロッテ,その他,146,西武ドーム,2022,5,5,木,0.0,18.7,7,0,7,7,5,7,12,-2,●,22741.88,23356.53
2022/5/6,15668,○,日本ハム,その他,174,西武ドーム,2022,5,6,金,0.0,17.8,5,0,5,5,7,0,7,7,○,22741.88,19710.77
2022/5/7,21577,●,日本ハム,その他,191,西武ドーム,2022,5,7,土,0.0,17.9,2,3,5,-1,5,0,5,5,○,22741.88,18786.29
2022/5/8,18793,○,日本ハム,その他,182,西武ドーム,2022,5,8,日,0.0,16.7,5,1,6,4,2,3,5,-1,●,22741.88,17143.54
2022/5/13,10121,○,楽天,その他,179,西武ドーム,2022,5,13,金,18.0,17.3,4,2,6,2,5,1,6,4,○,22741.88,19970.56
2022/5/14,12091,○,楽天,その他,184,西武ドーム,2022,5,14,土,8.5,20.4,5,4,9,1,4,2,6,2,○,22741.88,20046.41
2022/5/15,21224,●,楽天,その他,216,西武ドーム,2022,5,15,日,0.0,17.1,1,3,4,-2,5,4,9,1,○,22741.88,21160.21
2022/5/17,9841,●,ソフトバンク,その他,210,那覇,2022,5,17,火,0.0,14.7,1,5,6,-4,1,3,4,-2,●,22741.88,20806.97
2022/5/18,12404,●,ソフトバンク,その他,202,那覇,2022,5,18,水,0.0,17.5,2,3,5,-1,1,5,6,-4,●,22741.88,19713.64
2022/5/27,12234,●,DeNA,その他,169,西武ドーム,2022,5,27,金,69.5,20.0,0,1,1,-1,2,3,5,-1,●,22741.88,21138.49
2022/5/28,18824,○,DeNA,その他,195,西武ドーム,2022,5,28,土,0.0,20.9,10,5,15,5,0,1,1,-1,●,22741.88,20998.5
2022/5/29,22907,○,DeNA,その他,168,西武ドーム,2022,5,29,日,0.0,22.6,3,2,5,1,10,5,15,5,○,22741.88,22562.68
2022/6/7,16975,○,巨人,その他,200,西武ドーム,2022,6,7,火,11.0,15.8,9,4,13,5,3,2,5,1,○,22359.4,18786.29
2022/6/8,16809,○,巨人,その他,141,西武ドーム,2022,6,8,水,0.0,16.0,3,0,3,3,9,4,13,5,○,22359.4,17143.54
2022/6/9,16959,●,巨人,その他,200,西武ドーム,2022,6,9,木,1.0,18.2,3,4,7,-1,3,0,3,3,○,22359.4,18510.93
2022/6/10,17994,●,広島,その他,195,西武ドーム,2022,6,10,金,0.5,20.0,3,6,9,-3,3,4,7,-1,●,22359.4,17777.52
2022/6/11,24039,○,広島,その他,211,西武ドーム,2022,6,11,土,11.0,20.1,2,1,3,1,3,6,9,-3,●,22359.4,21121.18
2022/6/12,22139,○,広島,その他,184,西武ドーム,2022,6,12,日,13.5,20.3,11,0,11,11,2,1,3,1,○,22359.4,20345.97
2022/6/17,14360,○,オリックス,その他,167,西武ドーム,2022,6,17,金,0.0,21.7,4,2,6,2,11,0,11,11,○,22359.4,20806.97
2022/6/18,16075,●,オリックス,その他,165,西武ドーム,2022,6,18,土,2.0,21.5,0,2,2,-2,4,2,6,2,○,22359.4,19713.64
2022/6/19,16949,○,オリックス,その他,166,西武ドーム,2022,6,19,日,0.0,23.8,3,2,5,1,0,2,2,-2,●,22359.4,19628.91
2022/6/28,10520,○,日本ハム,その他,202,西武ドーム,2022,6,28,火,0.0,29.0,5,2,7,3,3,2,5,1,○,22359.4,20998.5
2022/6/29,10786,○,日本ハム,その他,157,西武ドーム,2022,6,29,水,0.0,29.9,6,2,8,4,5,2,7,3,○,22359.4,22562.68
2022/7/2,19768,●,ソフトバンク,その他,193,西武ドーム,2022,7,2,土,0.0,29.1,2,3,5,-1,6,2,8,4,○,19106.44,20570.03
2022/7/3,26532,●,ソフトバンク,その他,143,西武ドーム,2022,7,3,日,0.0,27.4,0,3,3,-3,2,3,5,-1,●,19106.44,21970.81
2022/7/12,8889,●,ロッテ,その他,209,西武ドーム,2022,7,12,火,45.0,25.0,2,4,6,-2,0,3,3,-3,●,19106.44,20345.97
2022/7/13,8896,○,ロッテ,その他,180,西武ドーム,2022,7,13,水,10.0,23.0,3,0,3,3,2,4,6,-2,●,19106.44,19970.56
2022/7/14,8382,○,ロッテ,今井,201,西武ドーム,2022,7,14,木,4.5,23.0,2,1,3,1,3,0,3,3,○,19106.44,20046.41
2022/7/22,19546,○,楽天,その他,229,西武ドーム,2022,7,22,金,1.5,27.3,9,4,13,5,2,1,3,1,○,19106.44,19673.16
2022/7/23,26641,△,楽天,その他,261,西武ドーム,2022,7,23,土,0.5,28.1,3,3,6,0,9,4,13,5,○,19106.44,21263.5
2022/7/24,13973,●,楽天,その他,197,西武ドーム,2022,7,24,日,0.0,28.0,2,9,11,-7,3,3,6,0,△,19106.44,18457.52
2022/8/2,9206,○,オリックス,その他,206,西武ドーム,2022,8,2,火,0.0,31.1,4,2,6,2,2,9,11,-7,●,20720.23,20570.03
2022/8/3,10237,○,オリックス,その他,163,西武ドーム,2022,8,3,水,0.0,31.4,3,1,4,2,4,2,6,2,○,20720.23,21970.81
2022/8/4,8018,○,オリックス,その他,181,西武ドーム,2022,8,4,木,9.5,24.5,3,2,5,1,3,1,4,2,○,20720.23,22697.37
2022/8/5,12619,○,ロッテ,今井,216,西武ドーム,2022,8,5,金,1.5,23.2,4,3,7,1,3,2,5,1,○,20720.23,23356.53
2022/8/6,19743,●,ロッテ,その他,167,西武ドーム,2022,8,6,土,0.0,24.3,1,2,3,-1,4,3,7,1,○,20720.23,19710.77
2022/8/7,22737,○,ロッテ,その他,210,西武ドーム,2022,8,7,日,0.0,26.2,10,4,14,6,1,2,3,-1,●,20720.23,18786.29
2022/8/16,18340,○,ソフトバンク,その他,154,西武ドーム,2022,8,16,火,0.0,28.9,2,0,2,2,10,4,14,6,○,20720.23,20196.04
2022/8/17,13258,●,ソフトバンク,その他,196,西武ドーム,2022,8,17,水,21.0,25.9,3,5,8,-2,2,0,2,2,○,20720.23,20806.97
2022/8/18,13372,○,ソフトバンク,その他,202,西武ドーム,2022,8,18,木,7.0,24.4,8,5,13,3,3,5,8,-2,●,20720.23,19713.64
2022/8/19,18793,●,オリックス,今井,199,西武ドーム,2022,8,19,金,0.0,26.4,3,4,7,-1,8,5,13,3,○,20720.23,19628.91
2022/8/20,19784,●,オリックス,その他,171,西武ドーム,2022,8,20,土,2.0,25.0,0,6,6,-6,3,4,7,-1,●,20720.23,20765.17
2022/8/21,15879,○,オリックス,その他,203,西武ドーム,2022,8,21,日,0.5,24.9,3,1,4,2,0,6,6,-6,●,20720.23,20805.45
2022/8/30,13390,○,日本ハム,その他,158,西武ドーム,2022,8,30,火,2.0,21.5,3,1,4,2,3,1,4,2,○,20720.23,21898.1
2022/8/31,11447,●,日本ハム,その他,206,西武ドーム,2022,8,31,水,0.5,26.0,2,4,6,-2,3,1,4,2,○,20720.23,21679.45
2022/9/6,9882,○,ロッテ,その他,154,西武ドーム,2022,9,6,火,0.0,26.5,3,2,5,1,2,4,6,-2,●,20473.55,19710.77
2022/9/7,12497,●,ロッテ,その他,176,西武ドーム,2022,9,7,水,18.0,25.2,1,7,8,-6,3,2,5,1,○,20473.55,18786.29
2022/9/8,11112,●,オリックス,その他,197,西武ドーム,2022,9,8,木,15.0,22.6,0,5,5,-5,1,7,8,-6,●,20473.55,17143.54
2022/9/10,27516,●,日本ハム,その他,220,西武ドーム,2022,9,10,土,0.5,24.6,1,2,3,-1,0,5,5,-5,●,20473.55,17777.52
2022/9/11,26539,○,日本ハム,その他,183,西武ドーム,2022,9,11,日,0.0,23.6,3,0,3,3,1,2,3,-1,●,20473.55,21121.18
2022/9/17,24167,●,楽天,その他,183,西武ドーム,2022,9,17,土,0.0,25.1,0,3,3,-3,3,0,3,3,○,20473.55,20806.97
2022/9/18,27471,●,楽天,その他,205,西武ドーム,2022,9,18,日,85.5,23.9,3,4,7,-1,0,3,3,-3,●,20473.55,19713.64
2022/9/19,27475,●,楽天,その他,257,西武ドーム,2022,9,19,月,48.5,26.1,4,6,10,-2,3,4,7,-1,●,20473.55,19628.91
2022/9/20,14063,○,楽天,その他,172,西武ドーム,2022,9,20,火,15.5,22.3,4,1,5,3,4,6,10,-2,●,20473.55,20765.17
2022/9/27,24030,○,ソフトバンク,その他,168,西武ドーム,2022,9,27,火,0.0,22.6,4,1,5,3,4,1,5,3,○,20473.55,21138.49
2022/10/1,27313,○,ソフトバンク,その他,225,西武ドーム,2022,10,1,土,0.0,21.8,3,1,4,2,4,1,5,3,○,16821.42,22001.45
2022/10/2,27259,●,日本ハム,その他,188,西武ドーム,2022,10,2,日,0.0,21.6,2,4,6,-2,3,1,4,2,○,16821.42,20570.03
